종목코드,종목명,시작일 기준가,종료일 종가,대비,등락률,거래량,거래대금
"060310","3S","2755","2610","-145","-5.26","19024966","52794480025"
"095570","AJ네트웍스","4275","4345","70","1.64","1932938","8152577275"
"006840","AK홀딩스","19080","19000","-80","-0.42","312331","6224084870"
"054620","APS","9040","8690","-350","-3.87","1344457","11503442980"
"265520","AP시스템","20350","19270","-1080","-5.31","1551176","31230424420"
"211270","AP위성","12600","12060","-540","-4.29","2581440","31182448890"
"027410","BGF","3715","3645","-70","-1.88","2348405","8454371215"
"282330","BGF리테일","166600","165300","-1300","-0.78","863236","145188929758"
"126600","BGF에코머티리얼즈","5750","5200","-550","-9.57","2446105","13070140720"
"138930","BNK금융지주","6730","6730","0","0.00","21560580","144257157800"
"001460","BYC","395000","427500","32500","8.23","3905","1622151500"
"001465","BYC우","145000","142300","-2700","-1.86","5374","736600100"
"013720","CBI","2510","1444","-1066","-42.47","6632780","12153337575"
"083790","CG인바이츠","4045","3760","-285","-7.05","5881922","22842725150"
"001040","CJ","62100","70000","7900","12.72","3983495","255653340000"
"079160","CJ CGV","6177","8820","2643","42.79","18200073","189042073960"
"035760","CJ ENM","62400","64700","2300","3.69","2044303","133610774000"
"311690","CJ 바이오사이언스","20650","20300","-350","-1.69","714571","13790384770"
"00104K","CJ4우(전환)","54400","58700","4300","7.90","147852","8156362800"
"000120","CJ대한통운","71400","78300","6900","9.66","2633062","198030690200"
"011150","CJ씨푸드","3340","3095","-245","-7.34","3359728","10604611365"
"011155","CJ씨푸드1우","23050","20600","-2450","-10.63","5633","120051760"
"001045","CJ우","42300","43800","1500","3.55","48321","2094783550"
"097950","CJ제일제당","267500","305000","37500","14.02","1125568","319896425000"
"097955","CJ제일제당 우","130200","136700","6500","4.99","56699","7376120400"
"051500","CJ프레시웨이","28750","26250","-2500","-8.70","775945","20594790150"
"058820","CMG제약","2015","2550","535","26.55","40779848","94619096720"
"023460","CNH","2100","2070","-30","-1.43","189267","392066992"
"056730","CNT85","1412","1382","-30","-2.12","4238980","5897448705"
"000480","CR홀딩스","21900","10280","-11620","-53.06","32274236","473559240950"
"065770","CS","1562","1415","-147","-9.41","835659","1195590501"
"083660","CSA 코스믹","1587","1273","-314","-19.79","4480706","7277211592"
"000590","CS홀딩스","58300","58700","400","0.69","54495","3263608100"
"012030","DB","2145","1952","-193","-9.00","68230993","143912072426"
"404950","DB금융스팩10호","2120","2120","0","0.00","0","0"
"367360","DB금융스팩9호","2125","2125","0","0.00","0","0"
"016610","DB금융투자","4045","4095","50","1.24","777704","3103238045"
"005830","DB손해보험","72000","79400","7400","10.28","5363212","399662075611"
"000990","DB하이텍","60100","55500","-4600","-7.65","12407066","735435225500"
"139130","DGB금융지주","7240","7410","170","2.35","10865180","79060701520"
"060900","DGP","7200","4000","-3200","-44.44","19002530","93831912915"
"025440","DH오토웨어","2860","2600","-260","-9.09","902766","2396854390"
"001530","DI동일","20150","21550","1400","6.95","5693763","134309634010"
"000210","DL","38250","40950","2700","7.06","2037545","78934187000"
"001880","DL건설","13450","11840","-1610","-11.97","338598","4235979990"
"000215","DL우","22800","21950","-850","-3.73","77260","1686711400"
"375500","DL이앤씨","31900","30800","-1100","-3.45","4899362","151254435150"
"37550L","DL이앤씨2우(전환)","23100","21800","-1300","-5.63","78631","1731001250"
"37550K","DL이앤씨우","19440","19160","-280","-1.44","67286","1297358990"
"068790","DMS","6090","5370","-720","-11.82","1854453","10367696995"
"007340","DN오토모티브","94400","89600","-4800","-5.08","795987","76276274200"
"004840","DRB동일","5450","5120","-330","-6.06","602117","3221424055"
"241520","DSC인베스트먼트","3535","3225","-310","-8.77","4988923","17884393415"
"065150","DSEN","337","311","-26","-7.72","6959722","2210564754"
"155660","DSR","5010","4565","-445","-8.88","823488","3845300680"
"069730","DSR제강","4770","4525","-245","-5.14","918178","4135446785"
"180400","DXVX","7400","7410","10","0.14","5785643","41761773170"
"017940","E1","50300","57200","6900","13.72","498815","26901989150"
"245620","EDGC","1679","1694","15","0.89","71012858","127888846493"
"037370","EG","17150","15870","-1280","-7.46","11571137","199286441930"
"278990","EMB","8600","12000","3400","39.53","45526","533319450"
"365550","ESR켄달스퀘어리츠","4000","3885","-115","-2.88","3252015","12708940305"
"050120","ES큐브","4100","3695","-405","-9.88","1104825","4053744370"
"383220","F&F","115600","105300","-10300","-8.91","4652676","495644959600"
"007700","F&F홀딩스","19720","17190","-2530","-12.83","1310929","23819507820"
"214270","FSN","3015","2920","-95","-3.15","38170526","140149159410"
"130500","GH신소재","3325","3200","-125","-3.76","1473207","4740011570"
"114090","GKL","14590","13200","-1390","-9.53","9040296","125702479010"
"900290","GRT","4745","3090","-1655","-34.88","7484702","29927216650"
"078930","GS","35000","38800","3800","10.86","4232848","159797686150"
"083450","GST","28850","27050","-1800","-6.24","3301775","96094714450"
"006360","GS건설","14520","14020","-500","-3.44","39527623","562798491180"
"001250","GS글로벌","2745","2610","-135","-4.92","19595133","52563050270"
"007070","GS리테일","22100","23950","1850","8.37","9306007","204670212750"
"078935","GS우","33300","34250","950","2.85","56785","1907215550"
"297890","HB솔루션","4755","5080","325","6.83","65179029","363199674030"
"078150","HB테크놀러지","2560","2560","0","0.00","55952303","146167085510"
"012630","HDC","6290","5910","-380","-6.04","1349886","7921864830"
"039570","HDC랩스","8140","7840","-300","-3.69","291647","2259387560"
"089470","HDC현대EP","4525","4140","-385","-8.51","1724985","7147702850"
"294870","HDC현대산업개발","10740","10170","-570","-5.31","5289844","55171463450"
"009540","HD한국조선해양","120300","122300","2000","1.66","8433618","1048159127546"
"267250","HD현대","58500","62500","4000","6.84","3993009","242395608800"
"267270","HD현대건설기계","83300","77000","-6300","-7.56","5736388","473467120100"
"322000","HD현대에너지솔루션","36800","32700","-4100","-11.14","1288442","45643863150"
"042670","HD현대인프라코어","11570","10970","-600","-5.19","126771903","1578527574540"
"267260","HD현대일렉트릭","66200","74300","8100","12.24","10875954","785856206300"
"329180","HD현대중공업","136300","134300","-2000","-1.47","3354650","468783531850"
"097230","HJ중공업","4525","4230","-295","-6.52","2294504","10095400430"
"195940","HK이노엔","29750","36250","6500","21.85","5671888","185212310400"
"014790","HL D&I","2600","2355","-245","-9.42","1390527","3431561975"
"028300","HLB","29425","30900","1475","5.01","31329469","1005761009900"
"003580","HLB글로벌","4775","4120","-655","-13.72","3847407","16746851825"
"278650","HLB바이오스텝","3735","3265","-470","-12.58","16240981","55322963655"
"343090","HLB사이언스","2375","2030","-345","-14.53","164701","352503675"
"067630","HLB생명과학","9650","9200","-450","-4.66","15461452","144493223960"
"024850","HLB이노베이션","4140","3340","-800","-19.32","15116142","52600096705"
"047920","HLB제약","12200","12840","640","5.25","8984017","117327433770"
"115450","HLB테라퓨틱스","5070","4040","-1030","-20.32","17325366","72940301640"
"204320","HL만도","53200","42800","-10400","-19.55","7038226","338200314200"
"060980","HL홀딩스","35200","35900","700","1.99","657395","23658779500"
"011200","HMM","18680","17300","-1380","-7.39","78004913","1431346368580"
"403870","HPSP","27250","35300","8050","29.54","64691966","2256339371448"
"036640","HRS","5480","5240","-240","-4.38","3299796","18206345965"
"082740","HSD엔진","11360","11370","10","0.09","24305287","285331879050"
"035000","HS애드","6100","5910","-190","-3.11","409325","2436962770"
"405350","IBKS제17호스팩","4295","3275","-1020","-23.75","4203285","15423986540"
"426550","IBKS제19호스팩","2325","2325","0","0.00","0","0"
"439730","IBKS제20호스팩","2380","2320","-60","-2.52","269148","625785410"
"442770","IBKS제21호스팩","2280","2225","-55","-2.41","545985","1219751905"
"448760","IBKS제22호스팩","2285","2245","-40","-1.75","786556","1802188340"
"003560","IHQ","239","239","0","0.00","0","0"
"095340","ISC","58800","90800","32000","54.42","27274355","2292914465050"
"099520","ITX-AI","1284","1284","0","0.00","0","0"
"175330","JB금융지주","8280","8670","390","4.71","9353099","79455119070"
"950170","JTC","3955","3780","-175","-4.42","931559","3448689800"
"234080","JW생명과학","13580","14800","1220","8.98","1030672","14311560290"
"067290","JW신약","2680","3110","430","16.04","7069223","21188344560"
"001060","JW중외제약","24500","42300","17800","72.65","19501381","704936883750"
"001067","JW중외제약2우B","57600","64900","7300","12.67","4003","248495200"
"001065","JW중외제약우","28550","34000","5450","19.09","27788","935377400"
"096760","JW홀딩스","3275","4095","820","25.04","4031923","15238792030"
"035900","JYP Ent.","132500","128100","-4400","-3.32","14470506","1890949247758"
"318000","KBG","11280","9240","-2040","-18.09","4592641","46394927550"
"024840","KBI메탈","1813","1683","-130","-7.17","11298876","19691142809"
"105560","KB금융","46700","50800","4100","8.78","30209170","1498000962938"
"432320","KB스타리츠","4310","3850","-460","-10.67","2017576","8328417000"
"024120","KB오토시스","5980","4725","-1255","-20.99","3992245","21021884050"
"455250","KB제25호스팩","2135","2080","-55","-2.58","759203","1618877060"
"002380","KCC","192400","209500","17100","8.89","852066","178116731000"
"021320","KCC건설","5590","5080","-510","-9.12","480926","2546734320"
"344820","KCC글라스","43850","41350","-2500","-5.70","655812","28019702900"
"036670","KCI","8220","7970","-250","-3.04","321342","2538451070"
"009070","KCTC","4355","4100","-255","-5.86","2097134","8606110080"
"009440","KC그린홀딩스","3675","3550","-125","-3.40","5419752","19704224275"
"112190","KC산업","2390","2050","-340","-14.23","58555","118292111"
"119650","KC코트렐","2170","1949","-221","-10.18","11478741","23844404746"
"044180","KD","772","733","-39","-5.05","22963303","20265262738"
"092220","KEC","2100","1798","-302","-14.38","66698688","123906690663"
"151860","KG ETS","13100","11880","-1220","-9.31","9022774","110261344570"
"046440","KG모빌리언스","6940","5750","-1190","-17.15","11562025","73382516620"
"003620","KG모빌리티","8260","8180","-80","-0.97","24372507","198759389040"
"016380","KG스틸","8910","8200","-710","-7.97","11582255","97702670150"
"035600","KG이니시스","11790","11080","-710","-6.02","2746348","30609878240"
"001390","KG케미칼","49350","42550","-6800","-13.78","8958245","415989822450"
"226360","KH 건설","319","319","0","0.00","0","0"
"111870","KH 전자","198","198","0","0.00","0","0"
"033180","KH 필룩스","442","442","0","0.00","0","0"
"060720","KH바텍","20900","17880","-3020","-14.45","10068146","194555012130"
"015590","KIB플러그에너지","1042","930","-112","-10.75","162777034","168581759729"
"001940","KISCO홀딩스","18320","17740","-580","-3.17","201187","3531559960"
"058400","KNN","962","922","-40","-4.16","6387639","5903691945"
"025000","KPX케미칼","46150","43400","-2750","-5.96","65423","2917450300"
"092230","KPX홀딩스","50700","49950","-750","-1.48","27590","1372118850"
"000040","KR모터스","574","511","-63","-10.98","6397030","3286632275"
"044450","KSS해운","8940","8440","-500","-5.59","2977292","26141636120"
"030200","KT","29500","31900","2400","8.14","19519518","590698094702"
"033780","KT&G","81700","83800","2100","2.57","6620885","550382402664"
"058850","KTcs","3340","3315","-25","-0.75","12522333","40487557495"
"058860","KTis","3100","3085","-15","-0.48","7026436","21063992125"
"060370","KT서브마린","8100","12710","4610","56.91","34885918","400095852650"
"122450","KX","4620","4470","-150","-3.25","1335530","6155620830"
"052900","KX하이텍","1393","1241","-152","-10.91","3632033","4725938238"
"376190","LB루셈","8320","7290","-1030","-12.38","1294866","10319827830"
"061970","LB세미콘","8150","7310","-840","-10.31","14399575","118434702740"
"309960","LB인베스트먼트","4355","4085","-270","-6.20","12482484","63805937420"
"093050","LF","16090","14160","-1930","-12.00","886453","12938728650"
"003550","LG","82800","84000","1200","1.45","5089025","433069862100"
"034220","LG디스플레이","15320","14120","-1200","-7.83","34729710","491772137782"
"051900","LG생활건강","437000","439500","2500","0.57","2006425","886275211281"
"051905","LG생활건강우","179800","187600","7800","4.34","190883","34779747700"
"373220","LG에너지솔루션","565000","553000","-12000","-2.12","13937907","7760908989500"
"003555","LG우","65100","63300","-1800","-2.76","91305","5866471700"
"032640","LG유플러스","10370","10280","-90","-0.87","19984483","203828608970"
"011070","LG이노텍","308000","261000","-47000","-15.26","4658014","1286427662000"
"066570","LG전자","125300","104700","-20600","-16.44","21590362","2471253131500"
"066575","LG전자우","54100","47400","-6700","-12.38","1010949","51022234600"
"037560","LG헬로비전","4250","4040","-210","-4.94","8175660","35296955755"
"051910","LG화학","664000","630000","-34000","-5.12","9197914","6233644560178"
"051915","LG화학우","372500","372500","0","0.00","2190824","894408936000"
"079550","LIG넥스원","86000","77200","-8800","-10.23","3613350","290479080600"
"006260","LS","89200","119000","29800","33.41","30912732","3640408410800"
"010120","LS ELECTRIC","79900","104800","24900","31.16","24306770","2598197553500"
"000680","LS네트웍스","2800","6630","3830","136.79","98156253","656607021995"
"229640","LS전선아시아","6890","10180","3290","47.75","174354919","1682271353130"
"108320","LX세미콘","122200","96500","-25700","-21.03","3729231","408135073800"
"001120","LX인터내셔널","35550","36050","500","1.41","26079402","1015047020250"
"108670","LX하우시스","46600","48500","1900","4.08","2235108","117216300950"
"108675","LX하우시스우","19940","20350","410","2.06","100629","2093839570"
"383800","LX홀딩스","7850","7880","30","0.38","8964427","74359665280"
"38380K","LX홀딩스1우","10150","9700","-450","-4.43","396440","4138716870"
"086960","MDS테크","2265","2045","-220","-9.71","57449922","127593917639"
"023150","MH에탄올","7190","7060","-130","-1.81","915762","6710086420"
"038340","MIT","1283","1283","0","0.00","0","0"
"035420","NAVER","195500","227500","32000","16.37","30074459","6567074582779"
"160550","NEW","7020","6890","-130","-1.85","10752318","80848648970"
"053290","NE능률","5920","4550","-1370","-23.14","11177739","59417321815"
"181710","NHN","23600","26050","2450","10.38","1320744","33105955750"
"060250","NHN KCP","9610","9890","280","2.91","6559135","61421907970"
"104200","NHN벅스","5080","4700","-380","-7.48","3523450","17961012235"
"400760","NH올원리츠","3335","3120","-215","-6.45","1390821","4531204035"
"005940","NH투자증권","9530","10320","790","8.29","12676059","124663226940"
"005945","NH투자증권우","9200","9460","260","2.83","663146","6120672060"
"338100","NH프라임리츠","4275","4130","-145","-3.39","533556","2221118830"
"034310","NICE","11330","12230","900","7.94","569881","6498002490"
"030190","NICE평가정보","9890","10650","760","7.68","3996872","40910436130"
"008260","NI스틸","7710","6140","-1570","-20.36","3563390","24583140300"
"004250","NPC","6570","6020","-550","-8.37","18599875","129568495850"
"004255","NPC우","3115","3025","-90","-2.89","5949974","20899331460"
"456040","OCI","136500","130600","-5900","-4.32","5073716","736051269000"
"010060","OCI홀딩스","105600","107200","1600","1.52","2614116","291126020900"
"178920","PI첨단소재","34900","30050","-4850","-13.90","5025090","160898823950"
"024940","PN풍년","5770","6820","1050","18.20","2260184","14063346140"
"005490","POSCO홀딩스","394000","597000","203000","51.52","77766302","45133063221870"
"218410","RFHIC","20550","18430","-2120","-10.32","5402811","105197219720"
"327260","RF머트리얼즈","14390","11430","-2960","-20.57","8019358","105952176690"
"091340","S&K폴리텍","3655","3085","-570","-15.60","1020877","3498297165"
"010950","S-Oil","63900","77500","13600","21.28","11205219","806778137480"
"010955","S-Oil우","48150","50700","2550","5.30","302846","14909433200"
"419530","SAMG엔터","23700","22800","-900","-3.80","3363031","79995887750"
"019550","SBI인베스트먼트","1009","890","-119","-11.79","15859235","14967936366"
"950110","SBI핀테크솔루션즈","5000","4325","-675","-13.50","838693","4323362275"
"034120","SBS","30500","25600","-4900","-16.07","1135822","30958213950"
"046140","SBS콘텐츠허브","6490","5720","-770","-11.86","2330877","13612510650"
"151910","SBW생명과학","589","486","-103","-17.49","7308640","3802796261"
"036120","SCI평가정보","3995","3650","-345","-8.64","13477437","52784939335"
"099220","SDN","1820","1550","-270","-14.84","7569034","12714764016"
"036540","SFA반도체","5130","5220","90","1.75","65016272","368301179820"
"255220","SG","1635","1351","-284","-17.37","17361073","27533614535"
"040610","SG&G","1855","1777","-78","-4.20","2533605","4589143929"
"049470","SGA","724","670","-54","-7.46","3922411","2760856819"
"184230","SGA솔루션즈","886","779","-107","-12.08","4322100","3513536865"
"005090","SGC에너지","24000","26050","2050","8.54","777693","19480283850"
"016250","SGC이테크건설","23100","22400","-700","-3.03","113047","2456781650"
"001380","SG글로벌","1360","1436","76","5.59","3798874","5359448254"
"004060","SG세계물산","527","478","-49","-9.30","12597204","6225602708"
"001770","SHD","25550","25150","-400","-1.57","104597","2642948800"
"002360","SH에너지화학","707","674","-33","-4.67","8980458","5971166834"
"009160","SIMPAC","5110","4640","-470","-9.20","3236355","15384022485"
"123700","SJM","4795","4020","-775","-16.16","2237787","9678234230"
"025530","SJM홀딩스","4600","3840","-760","-16.52","1163232","4854005400"
"034730","SK","143500","152000","8500","5.92","3660431","545425698600"
"011790","SKC","103200","97800","-5400","-5.23","8817543","887729584400"
"018670","SK가스","123000","124300","1300","1.06","134814","16350083400"
"001740","SK네트웍스","5150","6480","1330","25.83","43218149","252537977220"
"006120","SK디스커버리","34400","38650","4250","12.35","1153357","42290797150"
"006125","SK디스커버리우","27600","29450","1850","6.70","167096","4882966000"
"210980","SK디앤디","21350","21050","-300","-1.41","1846045","40132733940"
"068400","SK렌터카","9840","11600","1760","17.89","2053451","21860159380"
"395400","SK리츠","5000","4465","-535","-10.70","3596906","17049836250"
"302440","SK바이오사이언스","76500","84500","8000","10.46","8299328","662447393700"
"326030","SK바이오팜","77700","99300","21600","27.80","6789841","595792272400"
"402340","SK스퀘어","45200","45450","250","0.55","8064925","362591360621"
"260870","SK시그넷","53400","46600","-6800","-12.73","511799","25055990600"
"361610","SK아이이테크놀로지","93100","96500","3400","3.65","22185786","2295262790786"
"100090","SK오션플랜트","20600","21700","1100","5.34","12903680","281302657370"
"03473K","SK우","131500","134800","3300","2.51","30746","4021840700"
"096770","SK이노베이션","163238","190800","27562","16.88","31355933","6089813686750"
"096775","SK이노베이션우","106522","122300","15778","14.81","424446","53975422500"
"001510","SK증권","674","639","-35","-5.19","33173719","21388615262"
"001515","SK증권우","2430","2240","-190","-7.82","189514","431783430"
"285130","SK케미칼","67000","63900","-3100","-4.63","3336240","230035995100"
"28513K","SK케미칼우","31000","30800","-200","-0.65","807037","27872923650"
"017670","SK텔레콤","44200","46500","2300","5.20","13659366","622453945639"
"000660","SK하이닉스","113800","118500","4700","4.13","88333923","10491475629882"
"048550","SM C&C","2365","2330","-35","-1.48","23819040","62111406980"
"063440","SM Life Design","1827","2045","218","11.93","17396174","35322012153"
"003570","SNT다이내믹스","10000","9750","-250","-2.50","1729067","17344940060"
"064960","SNT모티브","54900","47100","-7800","-14.21","838376","42152109050"
"100840","SNT에너지","22950","22250","-700","-3.05","740817","16541391800"
"036530","SNT홀딩스","16100","15870","-230","-1.43","151526","2367167930"
"005610","SPC삼립","67500","67500","0","0.00","190029","12679179100"
"011810","STX","13810","15730","1920","13.90","100899117","1493358674670"
"077970","STX엔진","14400","14590","190","1.32","3886893","57850000730"
"071970","STX중공업","7890","12450","4560","57.79","52481827","589990327350"
"002820","SUN&L","2720","2710","-10","-0.37","497917","1378490735"
"289080","SV인베스트먼트","2045","1978","-67","-3.28","11447248","24444522658"
"084870","TBH글로벌","1813","1912","99","5.46","1139076","2050842308"
"002710","TCC스틸","40150","53500","13350","33.25","30171662","1716207948655"
"089230","THE E&M","273","278","5","1.83","35697583","9269515190"
"161570","THE MIDONG","2510","1291","-1219","-48.57","35997009","67353823376"
"032540","TJ미디어","6670","6520","-150","-2.25","703085","4451183300"
"022220","TKG애강","1406","1278","-128","-9.10","1924646","2540593558"
"069260","TKG휴켐스","21100","22350","1250","5.92","3241268","72901020450"
"048770","TPC","3360","3110","-250","-7.44","1296219","4033141215"
"246690","TS인베스트먼트","1519","1501","-18","-1.18","3656330","5356170660"
"317240","TS트릴리온","1655","1579","-76","-4.59","54089940","92885753844"
"002900","TYM","7370","6180","-1190","-16.15","8433978","57007642040"
"024070","WISCOM","2940","2755","-185","-6.29","281282","779608160"
"057030","YBM넷","3950","3640","-310","-7.85","1398344","5171070935"
"037270","YG PLUS","6530","5620","-910","-13.94","19148339","108426839975"
"040300","YTN","6900","7260","360","5.22","5873159","42950959190"
"051390","YW","4005","3720","-285","-7.12","535469","1997129260"
"052220","iMBC","3265","3325","60","1.84","2900955","9404740115"
"079940","가비아","12280","12920","640","5.21","1523079","19595548870"
"078890","가온그룹","6020","5800","-220","-3.65","3673803","22646255740"
"000500","가온전선","19830","22600","2770","13.97","4459341","101801216970"
"399720","가온칩스","37600","42800","5200","13.83","42711849","1915422956750"
"296520","가이아코퍼레이션","5500","5000","-500","-9.09","5465","29478180"
"036620","감성코퍼레이션","4080","4380","300","7.35","37374403","163626726675"
"000860","강남제비스코","22050","21000","-1050","-4.76","338734","7593588250"
"217730","강스템바이오텍","3200","2990","-210","-6.56","3527138","10443131680"
"035250","강원랜드","16890","16070","-820","-4.85","19354818","311093420475"
"114190","강원에너지","25350","22900","-2450","-9.66","22362391","608804056950"
"094480","갤럭시아머니트리","5510","5030","-480","-8.71","11351218","64499556420"
"011420","갤럭시아에스엠","2175","1917","-258","-11.86","6742710","14428926894"
"039240","경남스틸","3240","3025","-215","-6.64","2873227","8898761925"
"053950","경남제약","1561","1553","-8","-0.51","5791034","9006273783"
"002100","경농","9930","11050","1120","11.28","9475199","108423535640"
"009450","경동나비엔","52600","58000","5400","10.27","2799770","154668350500"
"267290","경동도시가스","20050","19760","-290","-1.45","276095","5408567690"
"012320","경동인베스트","86800","77300","-9500","-10.94","694944","59509156700"
"011040","경동제약","6910","7130","220","3.18","1417607","9811448810"
"000050","경방","9700","9470","-230","-2.37","158066","1508486860"
"214390","경보제약","6810","7820","1010","14.83","5933826","44353181050"
"012610","경인양행","4765","4240","-525","-11.02","3294269","14914594085"
"009140","경인전자","25600","22650","-2950","-11.52","98191","2382315250"
"024910","경창산업","3865","2935","-930","-24.06","7744675","25278547660"
"013580","계룡건설","16180","15310","-870","-5.38","1042028","16325980140"
"012200","계양전기","2195","2130","-65","-2.96","928069","2035428793"
"012205","계양전기우","4000","4070","70","1.75","45271","178011355"
"002140","고려산업","4025","3820","-205","-5.09","11853959","47586873610"
"198440","고려시멘트","2330","2125","-205","-8.80","3527701","7822286547"
"049720","고려신용정보","11300","10470","-830","-7.35","5167112","54652062970"
"010130","고려아연","463000","504000","41000","8.86","1693649","833701126000"
"002240","고려제강","19060","25000","5940","31.16","19606909","520960274310"
"014570","고려제약","6490","6670","180","2.77","2054031","13914982900"
"348150","고바이오랩","10700","10100","-600","-5.61","2773876","28325378390"
"098460","고영","15020","13340","-1680","-11.19","23145654","328474644342"
"035290","골드앤에스","1305","1234","-71","-5.44","35241728","52078744597"
"900280","골든센츄리","201","184","-17","-8.46","99077932","19525440153"
"215000","골프존","109400","96000","-13400","-12.25","933372","95015057500"
"121440","골프존뉴딘홀딩스","4760","4390","-370","-7.77","1567091","7025975520"
"183410","골프존데카","1751","1500","-251","-14.33","25288","37841339"
"366030","공구우먼","8040","7120","-920","-11.44","2820315","20992574630"
"076340","관악산업","6600","5800","-800","-12.12","8640","51732390"
"009290","광동제약","6360","6790","430","6.76","2172526","14111310180"
"014200","광림","1006","1006","0","0.00","0","0"
"017040","광명전기","2700","2655","-45","-1.67","44655281","127366769750"
"029480","광무","2990","4345","1355","45.32","126817194","491090963640"
"017900","광전자","2950","2545","-405","-13.73","27326850","75533639060"
"037710","광주신세계","33500","32150","-1350","-4.03","183240","5982556700"
"026910","광진실업","4735","4285","-450","-9.50","325052","1406562215"
"397880","교보11호스팩","2240","2225","-15","-0.67","320056","715193820"
"421800","교보12호스팩","2165","2085","-80","-3.70","469332","995774080"
"440790","교보13호스팩","2205","2105","-100","-4.54","682971","1476987795"
"456490","교보14호스팩","6810","2115","-4695","-68.94","91607313","457704022530"
"030610","교보증권","5180","5180","0","0.00","664900","3370195925"
"339770","교촌에프앤비","8470","7880","-590","-6.97","541301","4301630460"
"053270","구영테크","3720","2955","-765","-20.56","7586360","24929708195"
"007690","국도화학","51800","51600","-200","-0.39","864703","45219090300"
"005320","국동","1052","947","-105","-9.98","5903933","5664745050"
"001140","국보","6800","4705","-2095","-30.81","8891805","57328667945"
"066620","국보디자인","16220","15500","-720","-4.44","206736","3189243700"
"043650","국순당","5790","5870","80","1.38","1407881","8639451760"
"006050","국영지앤엠","1464","1314","-150","-10.25","2893097","3882858789"
"060480","국일신동","2810","3330","520","18.51","58315736","223774971010"
"078130","국일제지","800","800","0","0.00","0","0"
"307750","국전약품","5970","7500","1530","25.63","67234557","485885188950"
"002720","국제약품","3995","4155","160","4.01","6835303","29477589040"
"243870","굿센","12190","16490","4300","35.27","22071","314135730"
"035080","그래디언트","16730","14680","-2050","-12.25","1123890","17386485470"
"204020","그리티","3275","3415","140","4.27","1871084","6178220700"
"114450","그린생명과학","3305","3210","-95","-2.87","1212764","4019190505"
"083420","그린케미칼","8680","8060","-620","-7.14","2257064","19096642970"
"186230","그린플러스","10270","9580","-690","-6.72","10368643","116819211800"
"014530","극동유화","3850","4265","415","10.78","12310962","51085664210"
"900070","글로벌에스엠","780","688","-92","-11.79","3543914","2491121899"
"204620","글로벌텍스프리","3680","4040","360","9.78","19856180","71293480865"
"019660","글로본","1745","1847","102","5.85","3568981","5940142860"
"014280","금강공업","7270","5960","-1310","-18.02","19974650","136483316160"
"014285","금강공업우","11460","10380","-1080","-9.42","43154","453728510"
"053260","금강철강","6620","6000","-620","-9.37","1290503","8117526950"
"008870","금비","84800","93700","8900","10.50","204189","17727041400"
"001570","금양","73600","143100","69500","94.43","130654230","15902956481800"
"282720","금양그린파워","15450","13390","-2060","-13.33","13296060","224282071490"
"002990","금호건설","5800","5500","-300","-5.17","1451504","8066903930"
"002995","금호건설우","19300","15100","-4200","-21.76","18655","297293360"
"011780","금호석유","123800","122600","-1200","-0.97","1749802","215636572000"
"011785","금호석유우","65100","63300","-1800","-2.76","170468","10669909300"
"214330","금호에이치티","887","890","3","0.34","37425343","32313352717"
"001210","금호전기","1130","905","-225","-19.91","14545489","14861651201"
"073240","금호타이어","4685","4350","-335","-7.15","13347784","60912005455"
"036190","금화피에스시","30800","29500","-1300","-4.22","55558","1667305300"
"049080","기가레인","1724","1458","-266","-15.43","49301844","79764461925"
"420770","기가비스","90600","87700","-2900","-3.20","5098709","493663925900"
"035460","기산텔레콤","3510","2955","-555","-15.81","8606192","28481084440"
"092440","기신정기","3380","3250","-130","-3.85","769721","2524382625"
"000270","기아","89000","78900","-10100","-11.35","28766988","2401117665711"
"024110","기업은행","10140","10470","330","3.25","20107701","207215001800"
"013700","까뮤이앤씨","1672","1642","-30","-1.79","1593884","2657043998"
"308100","까스텔바작","7260","5810","-1450","-19.97","3002666","20049753950"
"004540","깨끗한나라","2475","2260","-215","-8.69","1649395","3781041880"
"004545","깨끗한나라우","15260","13840","-1420","-9.31","16007","224814180"
"407400","꿈비","12400","8780","-3620","-29.19","17007853","184605528390"
"187790","나노","1400","1225","-175","-12.50","12502181","17627307417"
"286750","나노브릭","1990","2910","920","46.23","44078093","127809191277"
"121600","나노신소재","130200","145600","15400","11.83","16201838","2590351520050"
"247660","나노씨엠에스","14250","18490","4240","29.75","10634581","201193886750"
"039860","나노엔텍","4230","4695","465","10.99","27788375","141623686515"
"091970","나노캠텍","884","736","-148","-16.74","3345878","2595464000"
"417010","나노팀","26950","19850","-7100","-26.35","10580953","271920417860"
"244880","나눔테크","3790","3800","10","0.26","28705","109446450"
"405920","나라셀라","7955","7960","5","0.06","6973102","98355767450"
"288490","나라소프트","50","67","17","34.00","12488185","956352862"
"051490","나라엠앤디","7800","6710","-1090","-13.97","5687524","41717261620"
"137080","나래나노텍","8600","7800","-800","-9.30","2222417","19050719410"
"190510","나무가","14830","14100","-730","-4.92","6752140","99219286380"
"242040","나무기술","2315","2695","380","16.41","154760289","461443298500"
"089600","나스미디어","20700","19350","-1350","-6.52","7161667","161247410520"
"293580","나우IB","1051","1126","75","7.14","14364538","16204479573"
"257990","나우코스","5070","4925","-145","-2.86","17181","78547505"
"138610","나이벡","12800","18240","5440","42.50","6843244","115289397230"
"130580","나이스디앤비","6610","6180","-430","-6.51","193112","1218790820"
"036800","나이스정보통신","23550","23550","0","0.00","723518","16804124950"
"267320","나인테크","3465","3460","-5","-0.14","41411106","157729998385"
"001260","남광토건","9400","9190","-210","-2.23","2051379","20444228430"
"008350","남선알미늄","2590","2430","-160","-6.18","46036265","114474490400"
"008355","남선알미우","23000","22700","-300","-1.30","54728","1278990800"
"004270","남성","2255","2220","-35","-1.55","17023687","37895291136"
"003920","남양유업","507000","438500","-68500","-13.51","85893","38936667500"
"003925","남양유업우","275000","239500","-35500","-12.91","17062","4245508500"
"025860","남해화학","8190","8130","-60","-0.73","4071237","33268779350"
"111710","남화산업","7520","7140","-380","-5.05","204858","1475966870"
"091590","남화토건","8190","8100","-90","-1.10","1391937","11079639030"
"168330","내츄럴엔도텍","2455","2480","25","1.02","2089476","5101721821"
"094860","네오리진","497","399","-98","-19.72","6890342","2978278281"
"253590","네오셈","3820","4295","475","12.43","128510616","664329593135"
"212560","네오오토","8950","7080","-1870","-20.89","2623763","21394292780"
"095660","네오위즈","41350","34200","-7150","-17.29","4753351","173415008700"
"042420","네오위즈홀딩스","22700","25600","2900","12.78","875730","21251190700"
"950220","네오이뮨텍","2175","2280","105","4.83","17489043","36236716991"
"311390","네오크레마","9150","8330","-820","-8.96","5217896","45863654780"
"085910","네오티스","4195","3890","-305","-7.27","980191","3961694715"
"092730","네오팜","23900","24950","1050","4.39","2083483","50357553450"
"290660","네오펙트","1431","1346","-85","-5.94","4495981","6099337611"
"306620","네온테크","3320","3015","-305","-9.19","3694300","11408627565"
"153460","네이블","8130","7900","-230","-2.83","275959","2171133380"
"007390","네이처셀","8560","7600","-960","-11.21","15466951","121190667080"
"033640","네패스","19880","20100","220","1.11","12917625","274541045620"
"330860","네패스아크","26200","26200","0","0.00","2519352","70952329100"
"005720","넥센","4410","4175","-235","-5.33","475708","2027465715"
"005725","넥센우","3155","2845","-310","-9.83","10812","31581795"
"002350","넥센타이어","8620","8060","-560","-6.50","3793524","32019612800"
"002355","넥센타이어1우B","3030","2965","-65","-2.15","240035","714253510"
"089140","넥스턴바이오","6900","7700","800","11.59","10772545","91538700310"
"137940","넥스트아이","501","400","-101","-20.16","46779978","23127182758"
"396270","넥스트칩","15600","13260","-2340","-15.00","16636354","231096195720"
"348210","넥스틴","71800","82900","11100","15.46","4657764","373992358600"
"225570","넥슨게임즈","21850","17950","-3900","-17.85","27378354","568862359240"
"217270","넵튠","7470","7770","300","4.02","2004584","15526904520"
"251270","넷마블","46450","49900","3450","7.43","4439744","212218695000"
"317860","노드메이슨","5980","5490","-490","-8.19","198","1016730"
"104620","노랑풍선","7040","7070","30","0.43","1152998","8054212580"
"090350","노루페인트","8050","8030","-20","-0.25","1393978","11105485100"
"090355","노루페인트우","13230","11560","-1670","-12.62","20854","248721140"
"000320","노루홀딩스","10380","10810","430","4.14","832925","9324571280"
"000325","노루홀딩스우","20600","19640","-960","-4.66","32814","655318320"
"194700","노바렉스","7840","8200","360","4.59","1168775","9415141200"
"285490","노바텍","36450","31800","-4650","-12.76","3619898","125351614700"
"283100","노보믹스","3695","4030","335","9.07","11218","46002120"
"229500","노브메타파마","19000","20500","1500","7.89","158822","3258087840"
"106520","노블엠앤비","411","411","0","0.00","0","0"
"376930","노을","3744","5220","1476","39.42","16581515","82983073530"
"006280","녹십자","111600","120300","8700","7.80","1191018","134285854700"
"142280","녹십자엠에스","4355","4605","250","5.74","1880615","8282598005"
"234690","녹십자웰빙","7010","6930","-80","-1.14","614858","4289916050"
"005250","녹십자홀딩스","13910","14860","950","6.83","1834307","25307986960"
"005257","녹십자홀딩스2우","30150","27100","-3050","-10.12","13978","389989250"
"065560","녹원씨엔아이","5770","5770","0","0.00","0","0"
"004370","농심","405500","411500","6000","1.48","532414","214997890500"
"072710","농심홀딩스","67000","67900","900","1.34","62508","4143560900"
"054050","농우바이오","8770","8530","-240","-2.74","1366671","11869558970"
"069140","누리플랜","4760","4085","-675","-14.18","1751312","8216212580"
"040160","누리플렉스","5810","5310","-500","-8.61","1022159","5619356685"
"332290","누보","2415","2380","-35","-1.45","86135840","245317328910"
"348340","뉴로메카","32550","36000","3450","10.60","17140035","573103537550"
"060260","뉴보텍","967","1094","127","13.13","24007451","25916058496"
"012340","뉴인텍","1820","1645","-175","-9.62","17022425","35320463756"
"214870","뉴지랩파마","1383","1383","0","0.00","0","0"
"270870","뉴트리","8250","6690","-1560","-18.91","732350","5020223610"
"144960","뉴파워프라즈마","6790","5400","-1390","-20.47","8251813","49626163910"
"085670","뉴프렉스","5610","4890","-720","-12.83","10856803","61836023255"
"064260","다날","3900","3720","-180","-4.62","10746162","40573905270"
"340360","다보링크","843","1080","237","28.11","9041241","8443896877"
"039560","다산네트웍스","5300","4770","-530","-10.00","83706239","535336242535"
"154040","다산솔루에타","3070","2100","-970","-31.60","33463844","100552854143"
"058730","다스코","4615","4440","-175","-3.79","5132857","23390611140"
"030210","다올투자증권","3755","3790","35","0.93","13207703","48725300300"
"023590","다우기술","17570","17850","280","1.59","1261175","22324073230"
"032190","다우데이타","13010","14110","1100","8.46","6962570","90635565750"
"323350","다원넥스뷰","8200","12000","3800","46.34","17171","158954930"
"068240","다원시스","13040","13880","840","6.44","17402026","260813756790"
"145210","다이나믹디자인","5890","4800","-1090","-18.51","10728285","60500928510"
"019680","대교","2610","2560","-50","-1.92","1308501","3252781010"
"019685","대교우B","1736","1665","-71","-4.09","1195623","2000287690"
"006370","대구백화점","14520","13150","-1370","-9.44","788615","10204716470"
"008060","대덕","6480","6700","220","3.40","2055665","13906059760"
"00806K","대덕1우","9430","9180","-250","-2.65","58495","549527500"
"353200","대덕전자","31200","30750","-450","-1.44","37299153","1315873889200"
"35320K","대덕전자1우","11520","10740","-780","-6.77","387558","4702963050"
"000490","대동","11600","10560","-1040","-8.97","3351575","36767573890"
"178600","대동고려삼","2995","2845","-150","-5.01","9281","24647985"
"020400","대동금속","9760","8650","-1110","-11.37","158769","1426898960"
"008830","대동기어","6080","5570","-510","-8.39","401041","2276833960"
"048470","대동스틸","4130","3840","-290","-7.02","879715","3422774560"
"008110","대동전자","5180","6440","1260","24.32","1372422","7973841690"
"004780","대륙제관","4420","4180","-240","-5.43","383976","1618882810"
"005750","대림B&Co","3720","3400","-320","-8.60","697292","2500926245"
"017650","대림제지","8770","8870","100","1.14","200206","1764278500"
"006570","대림통상","3505","3500","-5","-0.14","295834","1021783235"
"007720","대명소노시즌","696","648","-48","-6.90","4078990","2727954996"
"389260","대명에너지","25350","25750","400","1.58","1890878","48443292950"
"317850","대모","13740","11280","-2460","-17.90","6439786","85476892600"
"290670","대보마그네틱","55500","46950","-8550","-15.41","3133222","162048986700"
"078140","대봉엘에스","8340","12200","3860","46.28","35560694","425521888350"
"001680","대상","16720","17580","860","5.14","2346977","39703678000"
"001685","대상우","14230","13560","-670","-4.71","58131","795087160"
"084690","대상홀딩스","7490","6850","-640","-8.54","3177528","22181824140"
"084695","대상홀딩스우","8950","7970","-980","-10.95","191479","1566432440"
"036480","대성미생물","10360","10160","-200","-1.93","1705745","18464988690"
"128820","대성산업","4080","3855","-225","-5.51","4933129","19950964790"
"117580","대성에너지","7880","7330","-550","-6.98","1487490","10907057520"
"027830","대성창투","1800","1623","-177","-9.83","8259799","14305350174"
"104040","대성파인텍","1561","1415","-146","-9.35","3874528","5678692844"
"129920","대성하이텍","9530","8260","-1270","-13.33","2870428","25481323720"
"016710","대성홀딩스","14320","14790","470","3.28","2560877","36913856840"
"438220","대신밸런스제13호스팩","2225","2215","-10","-0.45","969075","2120551490"
"442310","대신밸런스제14호스팩","2475","2475","0","0.00","0","0"
"020180","대신정보통신","1173","1113","-60","-5.12","7752221","8743067110"
"003540","대신증권","13480","14000","520","3.86","1351756","18298823335"
"003547","대신증권2우B","12390","12410","20","0.16","424706","5210022140"
"003545","대신증권우","12980","13130","150","1.16","723531","9386168590"
"045390","대아티아이","3395","3115","-280","-8.25","18131184","60116167175"
"009190","대양금속","3820","3680","-140","-3.66","13990237","51105974985"
"108380","대양전기공업","12830","13500","670","5.22","647918","8536455420"
"006580","대양제지","3260","3260","0","0.00","0","0"
"014160","대영포장","1312","1200","-112","-8.54","3248071","3967163878"
"047040","대우건설","3925","4555","630","16.05","83102144","363656300500"
"009320","대우부품","1858","1539","-319","-17.17","8713937","14781914802"
"003090","대웅","12160","14110","1950","16.04","2365666","30517489170"
"069620","대웅제약","91900","106700","14800","16.10","987864","98068879800"
"007680","대원","6810","6360","-450","-6.61","432331","2745539450"
"000430","대원강업","5950","6090","140","2.35","170790289","1236263939450"
"048910","대원미디어","15320","13380","-1940","-12.66","1792635","25256568910"
"005710","대원산업","6420","5900","-520","-8.10","318427","1922057680"
"006340","대원전선","1160","1156","-4","-0.34","40473199","48159484034"
"006345","대원전선우","2430","2315","-115","-4.73","92126","208208980"
"003220","대원제약","13790","16510","2720","19.72","6397121","99887544990"
"024890","대원화성","2870","2410","-460","-16.03","14774950","40638370655"
"290380","대유","2300","2300","0","0.00","0","0"
"002880","대유에이텍","665","558","-107","-16.09","6965997","4165265490"
"290120","대유에이피","5430","4610","-820","-15.10","1337364","6549395975"
"000300","대유플러스","1009","927","-82","-8.13","66054387","66737083364"
"120240","대정화금","18070","19050","980","5.42","11296415","224226815940"
"003310","대주산업","2110","1955","-155","-7.35","12961693","27528751106"
"114920","대주이엔티","1747","1351","-396","-22.67","10924","17431032"
"078600","대주전자재료","102000","90100","-11900","-11.67","11157264","1161221997100"
"012800","대창","1466","1621","155","10.57","380178412","693761709875"
"015230","대창단조","7670","7420","-250","-3.26","12925038","103550390930"
"096350","대창솔루션","740","630","-110","-14.86","85926924","55805896019"
"140520","대창스틸","2895","2840","-55","-1.90","1158294","3372819865"
"131220","대한과학","6520","6600","80","1.23","590852","3848964260"
"010170","대한광통신","2155","2050","-105","-4.87","44760534","102664568013"
"054670","대한뉴팜","8820","8780","-40","-0.45","1006188","8779595460"
"001070","대한방직","13700","11060","-2640","-19.27","2171858","26972363770"
"023910","대한약품","27150","27150","0","0.00","326449","8731326800"
"006650","대한유화","135000","131600","-3400","-2.52","812240","108112159000"
"001440","대한전선","13580","12930","-650","-4.79","24121890","324124448990"
"084010","대한제강","13400","12780","-620","-4.63","778990","9986363150"
"001790","대한제당","3345","3045","-300","-8.97","39819994","127464406470"
"001795","대한제당우","2805","2555","-250","-8.91","3728617","9980459375"
"001130","대한제분","130300","132200","1900","1.46","56882","7449111600"
"003490","대한항공","25500","24150","-1350","-5.29","34650518","867994563200"
"003495","대한항공우","28800","26900","-1900","-6.60","71587","1980028650"
"005880","대한해운","1992","1913","-79","-3.97","28593721","55204336809"
"003830","대한화섬","101800","102300","500","0.49","6673","679686400"
"016090","대현","2145","2055","-90","-4.20","2770108","5738500449"
"069460","대호에이엘","1326","2240","914","68.93","61253967","115986026560"
"021040","대호특수강","5360","4855","-505","-9.42","239138","1205540025"
"021045","대호특수강우","8990","8050","-940","-10.46","12521","98963730"
"067080","대화제약","8280","8230","-50","-0.60","1472693","11772610650"
"298540","더네이쳐홀딩스","22200","21050","-1150","-5.18","2302227","50019131670"
"118000","더메디팜","525","492","-33","-6.29","10136857","4922812351"
"192080","더블유게임즈","41300","42950","1650","4.00","822305","33856741550"
"393890","더블유씨피","69900","71000","1100","1.57","13039869","992295420200"
"299170","더블유에스아이","2065","1901","-164","-7.94","1512996","2966185430"
"012510","더존비즈온","29100","31650","2550","8.76","4008626","119770073500"
"224060","더코디","5610","6500","890","15.86","5406274","36514573800"
"302920","더콘텐츠온","9800","9200","-600","-6.12","12488","112145330"
"213420","덕산네오룩스","45150","40850","-4300","-9.52","2796930","117168035600"
"317330","덕산테코피아","18240","15570","-2670","-14.64","2262243","37476071860"
"077360","덕산하이메탈","8680","7670","-1010","-11.64","52455400","484880636900"
"004830","덕성","4340","7800","3460","79.72","170468556","1585122234555"
"004835","덕성우","5190","7080","1890","36.42","14160006","126036650960"
"090410","덕신하우징","2600","2225","-375","-14.42","57071588","144472732940"
"024900","덕양산업","9220","6630","-2590","-28.09","38239711","321395362210"
"263600","덕우전자","9770","9550","-220","-2.25","12311969","124750109420"
"194480","데브시스터즈","40450","36000","-4450","-11.00","1836791","68824547350"
"348840","데이드림엔터","4200","4020","-180","-4.29","4378","16708710"
"263800","데이타솔루션","6130","5420","-710","-11.58","6680380","39759472545"
"199150","데이터스트림즈","8180","7170","-1010","-12.35","19151","139428030"
"206560","덱스터","9960","8720","-1240","-12.45","4089573","39203401280"
"261200","덴티스","11160","13650","2490","22.31","30972533","431617881960"
"145720","덴티움","152200","146500","-5700","-3.75","2164793","308819418000"
"227420","도부마스크","904","904","0","0.00","0","0"
"067990","도이치모터스","5520","4900","-620","-11.23","1958431","9961121070"
"002150","도화엔지니어링","8580","8250","-330","-3.85","4009000","34972320890"
"006620","동구바이오제약","5680","5530","-150","-2.64","1714656","9231375655"
"100130","동국S&C","4045","3460","-585","-14.46","3894021","13992945610"
"005160","동국산업","6290","6010","-280","-4.45","22714333","154358422200"
"460850","동국씨엠","10230","9030","-1200","-11.73","6433748","61392770640"
"075970","동국알앤에스","5370","4015","-1355","-25.23","43740694","232847695740"
"460860","동국제강","9950","12910","2960","29.75","31357961","377553852800"
"086450","동국제약","13280","14330","1050","7.91","2997440","40822375160"
"001230","동국홀딩스","16100","12510","-3590","-22.30","22552045","379260086370"
"023450","동남합성","39000","34600","-4400","-11.28","24951","902675500"
"004140","동방","2200","2070","-130","-5.91","8184992","17492112763"
"099410","동방선기","3075","2790","-285","-9.27","2388573","7253483900"
"007590","동방아그로","6820","6650","-170","-2.49","223222","1506271730"
"005960","동부건설","6620","6310","-310","-4.68","2428808","15475235030"
"005965","동부건설우","27000","27550","550","2.04","18226","475353650"
"026960","동서","18770","18220","-550","-2.93","1792949","32942966720"
"002210","동성제약","5900","5930","30","0.51","1276577","7448630970"
"102260","동성케미컬","4510","4710","200","4.43","2163614","10107464435"
"033500","동성화인텍","12980","14660","1680","12.94","12637978","179360720350"
"025950","동신건설","11870","10060","-1810","-15.25","637138","6627441700"
"000640","동아쏘시오홀딩스","79900","91800","11900","14.89","266578","22202163300"
"170900","동아에스티","55700","69000","13300","23.88","918851","54879192200"
"088130","동아엘텍","7650","7060","-590","-7.71","1464253","11752529370"
"028100","동아지질","12360","12000","-360","-2.91","656168","7958616590"
"282690","동아타이어","11610","11380","-230","-1.98","317206","3624577320"
"041930","동아화성","9640","8190","-1450","-15.04","2268988","19949615830"
"001520","동양","1034","984","-50","-4.84","6845121","6616005412"
"001527","동양2우B","12270","10890","-1380","-11.25","75388","817951780"
"084670","동양고속","15620","14190","-1430","-9.15","33706","495530730"
"082640","동양생명","3600","3695","95","2.64","2340823","8373311300"
"060380","동양에스텍","2815","2485","-330","-11.72","8497219","23583077045"
"001525","동양우","6030","5210","-820","-13.60","76371","384634010"
"079960","동양이엔피","19450","20150","700","3.60","3397961","70989430740"
"008970","동양철관","1012","913","-99","-9.78","12942054","12254033979"
"228340","동양파일","3240","3105","-135","-4.17","957319","2912225360"
"092780","동양피스톤","5530","5590","60","1.08","1899584","10845731120"
"088910","동우팜투테이블","2955","2760","-195","-6.60","3121419","8583581505"
"094170","동운아나텍","26250","25650","-600","-2.29","68994064","2392487297100"
"049770","동원F&B","26700","28100","1400","5.24","315454","8569106100"
"013120","동원개발","3355","3405","50","1.49","2017347","6780085495"
"018500","동원금속","3355","2500","-855","-25.48","81955752","268272112610"
"006040","동원산업","36500","38950","2450","6.71","789610","30910445100"
"030720","동원수산","8090","9360","1270","15.70","1685983","15840648330"
"014820","동원시스템즈","35800","36850","1050","2.93","2686473","106107512600"
"014825","동원시스템즈우","24350","23900","-450","-1.85","9361","225390650"
"163560","동일고무벨트","6870","6470","-400","-5.82","787757","5443471700"
"109860","동일금속","11510","11830","320","2.78","3984142","47268406970"
"032960","동일기연","13640","12780","-860","-6.30","1340749","17605142240"
"004890","동일산업","62000","59300","-2700","-4.35","757317","44389697000"
"002690","동일제강","2150","1908","-242","-11.26","982815","1945217156"
"023790","동일철강","2215","1876","-339","-15.30","830608","1661325989"
"005290","동진쎄미켐","39400","37050","-2350","-5.96","34612029","1381398070950"
"025900","동화기업","39500","37900","-1600","-4.05","1173280","46311517750"
"000020","동화약품","10300","10520","220","2.14","3030527","30593864810"
"000150","두산","86500","110100","23600","27.28","8062558","840601535200"
"000157","두산2우B","86400","95800","9400","10.88","91179","9109119500"
"241560","두산밥캣","58900","56500","-2400","-4.07","11540479","682624967869"
"034020","두산에너빌리티","17400","17000","-400","-2.30","139196980","2461983186740"
"000155","두산우","50800","56200","5400","10.63","387382","22453727700"
"131970","두산테스나","40650","45700","5050","12.42","12517698","580773995700"
"336260","두산퓨얼셀","27100","25950","-1150","-4.24","8303933","222297273060"
"33626K","두산퓨얼셀1우","8580","8290","-290","-3.38","718436","5871736550"
"33626L","두산퓨얼셀2우B","9950","10020","70","0.70","249557","2393264220"
"016740","두올","4240","3550","-690","-16.27","10547831","41169955030"
"073190","듀오백","2300","2470","170","7.39","897138","2093068325"
"176750","듀켐바이오","6080","6060","-20","-0.33","99922","597837080"
"030350","드래곤플라이","576","501","-75","-13.02","13247739","6922138142"
"203650","드림시큐리티","3370","3240","-130","-3.86","13880554","44783938330"
"223250","드림씨아이에스","12980","14140","1160","8.94","1306506","17572400540"
"060570","드림어스컴퍼니","3000","3325","325","10.83","39673445","156233627030"
"192650","드림텍","10090","13490","3400","33.70","36748831","450716756120"
"217620","디딤이앤에프","1004","1176","172","17.13","98907864","104162902163"
"016670","디모아","443","388","-55","-12.42","10129497","4190346007"
"187870","디바이스이엔지","17140","14240","-2900","-16.92","536756","8482393020"
"066670","디스플레이텍","7310","6330","-980","-13.41","4541680","31397998980"
"024090","디씨엠","12280","12000","-280","-2.28","336017","4061980260"
"003160","디아이","7760","7740","-20","-0.26","3233647","25328714410"
"092200","디아이씨","6190","5070","-1120","-18.09","21030520","126566892920"
"110990","디아이티","8750","11370","2620","29.94","9635612","111929437850"
"078590","디아크","2380","2380","0","0.00","0","0"
"263690","디알젬","11560","11150","-410","-3.55","993125","11358114370"
"214680","디알텍","3290","2960","-330","-10.03","98829669","300949892280"
"377190","디앤디플랫폼리츠","3225","2990","-235","-7.29","1868814","5756113710"
"263720","디앤씨미디어","18410","18320","-90","-0.49","1651521","31691396370"
"376300","디어유","40700","35700","-5000","-12.29","4577971","176025340150"
"141020","디에스앤엘","3735","3735","0","0.00","0","0"
"109740","디에스케이","5000","5080","80","1.60","884700","4362699600"
"196490","디에이테크놀로지","4885","4570","-315","-6.45","38827012","177072972660"
"066900","디에이피","3470","3555","85","2.45","13907378","56991622740"
"127120","디엔에이링크","3365","3360","-5","-0.15","2100412","7022288415"
"092070","디엔에프","19400","23950","4550","23.45","10504131","246943064960"
"039840","디오","33750","30650","-3100","-9.19","5010515","166684922350"
"013570","디와이","6200","5700","-500","-8.06","4630624","28369626910"
"219550","디와이디","1362","1265","-97","-7.12","102536847","168515905232"
"310870","디와이씨","2070","1873","-197","-9.52","3677020","7163593944"
"210540","디와이파워","16350","14160","-2190","-13.39","4815341","76895488300"
"104460","디와이피엔에프","18820","23250","4430","23.54","4690941","108233444200"
"079810","디이엔티","16297","29600","13303","81.63","24529264","723442761630"
"113810","디젠스","1332","1072","-260","-19.52","12236118","14823320299"
"043360","디지아이","3110","2990","-120","-3.86","690767","2040118515"
"197140","디지캡","4380","5840","1460","33.33","2780785","13767358710"
"068930","디지털대성","6390","5850","-540","-8.45","1001432","6206404130"
"033130","디지틀조선","2145","2020","-125","-5.83","3019976","6145728874"
"105740","디케이락","12000","11550","-450","-3.75","4652289","54701730610"
"263020","디케이앤디","3565","3260","-305","-8.56","2291408","7515228635"
"290550","디케이티","11230","9630","-1600","-14.25","3654045","38442139640"
"187220","디티앤씨","5120","4500","-620","-12.11","3019552","14429611020"
"383930","디티앤씨알오","4935","5640","705","14.29","7135005","38497182565"
"163430","디피코","4010","4010","0","0.00","0","0"
"131180","딜리","1359","1238","-121","-8.90","1324190","1688284816"
"315640","딥노이드","11920","22350","10430","87.50","45012605","769708416400"
"317120","라닉스","5320","4660","-660","-12.41","709929","3453027865"
"042510","라온시큐어","2595","2560","-35","-1.35","34690665","93997512305"
"232680","라온테크","9910","9570","-340","-3.43","4179228","43006212760"
"418420","라온텍","8980","8460","-520","-5.79","32090854","281952720480"
"300120","라온피플","6790","7850","1060","15.61","26707708","216642591200"
"171120","라이온켐텍","5800","4345","-1455","-25.09","3460260","23232122030"
"388790","라이콤","3010","2380","-630","-20.93","13263170","37310885840"
"069540","라이트론","3295","3530","235","7.13","30864399","114722295215"
"347700","라이프시맨틱스","4640","4820","180","3.88","3009749","15327130960"
"214260","라파스","19600","30250","10650","54.34","10289266","272021871230"
"403360","라피치","21300","12330","-8970","-42.11","17209","317800110"
"115390","락앤락","5960","5760","-200","-3.36","920083","5390342040"
"200350","래몽래인","18000","14650","-3350","-18.61","1547665","24572411560"
"171010","램테크놀러지","6490","5840","-650","-10.02","8834513","59432037540"
"084650","랩지노믹스","3660","6050","2390","65.30","112332325","897201405325"
"217500","러셀","4020","3920","-100","-2.49","12032929","48610949480"
"092590","럭스피아","1540","1520","-20","-1.30","921","1189836"
"141080","레고켐바이오","34550","36250","1700","4.92","6666263","232603884550"
"038390","레드캡투어","16190","15720","-470","-2.90","293424","4645402980"
"294140","레몬","6300","4385","-1915","-30.40","11008699","52694961780"
"228670","레이","35550","36700","1150","3.23","5333069","204523538400"
"228850","레이언스","10960","10360","-600","-5.47","491120","5182373210"
"412350","레이저쎌","12000","12160","160","1.33","58051051","824792246960"
"281740","레이크머티리얼즈","19650","17940","-1710","-8.70","70113044","1417475814660"
"277810","레인보우로보틱스","92200","142800","50600","54.88","33668809","4063618875800"
"179720","렌딩머신","5000","4710","-290","-5.80","1017","4733900"
"215100","로보로보","4735","5750","1015","21.44","21033289","118125539790"
"090360","로보스타","28050","32150","4100","14.62","6045544","185228732300"
"238500","로보쓰리에이아이앤로보틱스","590","633","43","7.29","1218102","723206221"
"108490","로보티즈","27000","28850","1850","6.85","8131537","223825802050"
"900260","로스웰","919","737","-182","-19.80","3510665","3095384081"
"223220","로지스몬","547","487","-60","-10.97","1754","854204"
"067730","로지시스","3955","3595","-360","-9.10","950756","3641525845"
"071280","로체시스템즈","6810","6500","-310","-4.55","10917879","80185862210"
"032350","롯데관광개발","10240","10270","30","0.29","12194479","124358128326"
"089860","롯데렌탈","27100","26500","-600","-2.21","1115177","29499030950"
"330590","롯데리츠","3640","3455","-185","-5.08","4620004","16431763440"
"000400","롯데손해보험","1803","1738","-65","-3.61","3498953","5861873052"
"023530","롯데쇼핑","66800","72600","5800","8.68","1342870","93957921600"
"020150","롯데에너지머티리얼즈","54400","54100","-300","-0.55","11995627","655732395500"
"280360","롯데웰푸드","99500","98700","-800","-0.80","268931","26124586800"
"004000","롯데정밀화학","66400","61100","-5300","-7.98","1702005","110318663500"
"286940","롯데정보통신","24650","26600","1950","7.91","995422","25453550100"
"004990","롯데지주","24850","25600","750","3.02","2856985","72015960750"
"00499K","롯데지주우","37300","36000","-1300","-3.49","14025","510265400"
"005300","롯데칠성","122700","132000","9300","7.58","918571","115741829300"
"005305","롯데칠성우","61600","66400","4800","7.79","20841","1340613300"
"011170","롯데케미칼","152900","143400","-9500","-6.21","2843168","427292622100"
"071840","롯데하이마트","9160","10030","870","9.50","1102519","10769317780"
"328130","루닛","175200","170900","-4300","-2.45","16078914","2828989785256"
"038060","루멘스","1491","1335","-156","-10.46","3836294","5245202705"
"162120","루켄테크놀러지스","5060","4445","-615","-12.15","135698","610920700"
"253610","루트락","2205","2085","-120","-5.44","28439","52564322"
"085370","루트로닉","36400","36700","300","0.82","4065727","148193732600"
"08537M","루트로닉3우C","52000","55000","3000","5.77","20315","1074614700"
"060240","룽투코리아","2125","2040","-85","-4.00","9562885","20821416999"
"058470","리노공업","149900","160600","10700","7.14","3085720","497776993400"
"039980","리노스","870","850","-20","-2.30","3362330","2814953386"
"019570","리더스 기술투자","662","935","273","41.24","40605397","34339493251"
"016100","리더스코스메틱","2640","2425","-215","-8.14","580713","1508287800"
"012700","리드코프","5990","6000","10","0.17","1546737","9252759460"
"302550","리메드","15900","18700","2800","17.61","4545389","86404084920"
"073570","리튬포어스","21650","17300","-4350","-20.09","23565716","467286028700"
"377450","리파인","8100","7830","-270","-3.33","5578260","45976448880"
"277070","린드먼아시아","5690","5440","-250","-4.39","7304416","46092203015"
"042500","링네트","4310","4240","-70","-1.62","720837","3030319475"
"219420","링크제니시스","6270","5800","-470","-7.50","3387158","21192915020"
"439090","마녀공장","34900","27450","-7450","-21.35","8791538","251089778900"
"027740","마니커","1462","1160","-302","-20.66","11861897","14847697701"
"195500","마니커에프앤지","4285","3475","-810","-18.90","18708798","76631806745"
"357430","마스턴프리미어리츠","3235","2915","-320","-9.89","847719","2581233325"
"377480","마음AI","22400","24850","2450","10.94","12695665","332244287950"
"305090","마이크로디지탈","7400","7430","30","0.41","4098415","29385060880"
"448780","마이크로엔엑스","2965","2570","-395","-13.32","107551","276508810"
"098120","마이크로컨텍솔","8060","7600","-460","-5.71","2816167","23910197520"
"424980","마이크로투나노","22850","19240","-3610","-15.80","6765672","143473877310"
"038290","마크로젠","23100","22950","-150","-0.65","2061788","45821949580"
"001080","만호제강","36050","45550","9500","26.35","561795","24317071350"
"267980","매일유업","41850","41450","-400","-0.96","238000","9736528850"
"005990","매일홀딩스","8290","8300","10","0.12","111122","936533170"
"093520","매커스","14050","12270","-1780","-12.67","2751176","36864519280"
"377030","맥스트","9630","8150","-1480","-15.37","3656339","31475275900"
"088980","맥쿼리인프라","12570","11940","-630","-5.01","19244906","235169090820"
"094800","맵스리얼티1","4175","4005","-170","-4.07","1082910","4427145980"
"100590","머큐리","5730","5270","-460","-8.03","1585819","8722761210"
"067280","멀티캠퍼스","32800","32600","-200","-0.61","182627","5861155200"
"072870","메가스터디","10800","10240","-560","-5.19","291626","3029317760"
"215200","메가스터디교육","52100","50200","-1900","-3.65","1249028","62625500350"
"133750","메가엠디","2155","2110","-45","-2.09","2300573","4775463834"
"235980","메드팩토","14350","15100","750","5.23","4893256","71347508320"
"200580","메디쎄이","12710","12300","-410","-3.23","30654","384388090"
"041920","메디아나","5860","5900","40","0.68","9387906","57829500280"
"233250","메디안디노스틱","17500","15950","-1550","-8.86","1495","23348030"
"014100","메디앙스","3030","2820","-210","-6.93","592403","1675281495"
"236340","메디젠휴먼케어","5000","4200","-800","-16.00","9205","41044755"
"054180","메디콕스","1382","1884","502","36.32","35960038","64670667808"
"086900","메디톡스","256500","218500","-38000","-14.81","3061369","675029324900"
"078160","메디포스트","13980","9310","-4670","-33.40","3568556","38351462100"
"065650","메디프론","2115","1453","-662","-31.30","71411389","131337017508"
"138040","메리츠금융지주","42250","49500","7250","17.16","13726017","642701861100"
"408920","메쎄이상","3095","2775","-320","-10.34","1892747","5906874195"
"021880","메이슨캐피탈","368","318","-50","-13.59","11858188","4104816996"
"140410","메지온","43050","44500","1450","3.37","14023417","569881359650"
"241770","메카로","12800","11860","-940","-7.34","551093","6902643510"
"090370","메타랩스","2835","2685","-150","-5.29","998434","2600968385"
"059210","메타바이오메드","4720","4065","-655","-13.88","21738527","95176758925"
"058110","멕아이씨에스","3505","3420","-85","-2.43","4599534","16144670590"
"017180","명문제약","2365","2455","90","3.81","2159562","5113569675"
"257370","명성티엔에스","9210","9210","0","0.00","0","0"
"009900","명신산업","24950","18900","-6050","-24.25","16625819","353702134940"
"012690","모나리자","2850","2660","-190","-6.67","2200486","6002487660"
"005360","모나미","3540","3075","-465","-13.14","1396633","4475316790"
"434480","모니터랩","8580","6870","-1710","-19.93","5013871","37722462760"
"080420","모다이노칩","3110","2950","-160","-5.14","911238","2658641745"
"417970","모델솔루션","18250","17750","-500","-2.74","1674689","32020846240"
"080160","모두투어","15850","15700","-150","-0.95","2392191","36916175620"
"204210","모두투어리츠","3820","3905","85","2.23","626925","2396897570"
"087260","모바일어플라이언스","2920","2540","-380","-13.01","3968772","10667893975"
"101330","모베이스","3875","3555","-320","-8.26","3411149","11997556710"
"012860","모베이스전자","2750","2425","-325","-11.82","52489927","141250621825"
"363260","모비데이즈","1017","843","-174","-17.11","389267591","493969308562"
"348030","모비릭스","8940","9080","140","1.57","2163495","22014213200"
"250060","모비스","2290","2775","485","21.18","277537708","1025660435723"
"288980","모아데이타","2735","2510","-225","-8.23","23887782","66422250440"
"033200","모아텍","4925","4720","-205","-4.16","140571","664391895"
"333050","모코엠시스","1577","1458","-119","-7.55","15968208","26823062550"
"009680","모토닉","9110","8890","-220","-2.41","370115","3284115140"
"118990","모트렉스","18900","17900","-1000","-5.29","10964543","200039301540"
"006920","모헨즈","4610","4040","-570","-12.36","3693504","16405936505"
"009580","무림P&P","3650","3430","-220","-6.03","2300214","7998550425"
"001810","무림SP","2220","2010","-210","-9.46","766043","1590970550"
"009200","무림페이퍼","2370","2400","30","1.27","3230569","7646838185"
"322970","무진메디","3255","2865","-390","-11.98","83035","235417590"
"033920","무학","5530","5490","-40","-0.72","825373","4577388630"
"008420","문배철강","3515","3240","-275","-7.82","6887295","23845868140"
"279600","미디어젠","11700","10610","-1090","-9.32","540000","6724422740"
"095500","미래나노텍","23700","22200","-1500","-6.33","46369574","1225268501200"
"254490","미래반도체","24650","23350","-1300","-5.27","15581421","433072233400"
"025560","미래산업","23800","31500","7700","32.35","17598610","537131912000"
"218150","미래생명자원","6860","5320","-1540","-22.45","35841152","239688574310"
"007120","미래아이앤지","1654","1491","-163","-9.85","4017107","6097637545"
"396690","미래에셋글로벌리츠","3305","3000","-305","-9.23","1626675","5029798960"
"442900","미래에셋드림스팩1호","9490","9450","-40","-0.42","516171","4882415550"
"357250","미래에셋맵스리츠","3240","3040","-200","-6.17","1532709","4744127720"
"100790","미래에셋벤처투자","5100","5040","-60","-1.18","2104931","10505814505"
"412930","미래에셋비전스팩1호","2180","2085","-95","-4.36","298961","637599370"
"446190","미래에셋비전스팩2호","2195","2105","-90","-4.10","236812","507948525"
"448830","미래에셋비전스팩3호","2150","2080","-70","-3.26","319472","674289290"
"085620","미래에셋생명","3510","3725","215","6.13","2174788","7772328215"
"006800","미래에셋증권","7040","7020","-20","-0.28","16353444","113826186760"
"00680K","미래에셋증권2우B","3710","3630","-80","-2.16","1595671","5739738505"
"006805","미래에셋증권우","3970","3755","-215","-5.42","331081","1258687590"
"208890","미래엔에듀파트너","1200","1299","99","8.25","130","150258"
"049950","미래컴퍼니","36900","45450","8550","23.17","16138273","726139990600"
"207760","미스터블루","2260","2245","-15","-0.66","20599790","45665760771"
"002840","미원상사","172100","166200","-5900","-3.43","38818","6484167700"
"268280","미원에스씨","160900","142600","-18300","-11.37","25531","3778623900"
"107590","미원홀딩스","100000","94100","-5900","-5.90","13462","1303998600"
"134380","미원화학","64100","70000","5900","9.20","59105","3852504500"
"003650","미창석유","66900","66700","-200","-0.30","13417","890141500"
"059090","미코","11060","10890","-170","-1.54","26692927","329275354390"
"214610","미코바이오메드","4000","4790","790","19.75","4571727","21649355470"
"201490","미투온","3130","3045","-85","-2.72","4042658","12561360705"
"950190","미투젠","10400","10930","530","5.10","530005","5560470640"
"155900","바다로19호","2875","2900","25","0.87","615210","1770593315"
"206640","바디텍메드","13240","17830","4590","34.67","10450911","160603641870"
"018700","바른손","2385","1895","-490","-20.55","4254095","8300917473"
"035620","바른손이앤에이","831","677","-154","-18.53","4370627","3251231326"
"354390","바스칸바이오제약","6390","6680","290","4.54","5100","29568020"
"053030","바이넥스","9880","10530","650","6.58","3968748","39787038350"
"301300","바이브컴퍼니","8330","9300","970","11.64","3982116","37063634430"
"377740","바이오노트","4840","5670","830","17.15","11535216","65455168165"
"064550","바이오니아","45950","47000","1050","2.29","13018933","583457303500"
"314930","바이오다인","40200","54000","13800","34.33","1020818","49604993250"
"208710","바이오로그디바이스","1236","1119","-117","-9.47","27522679","31407517056"
"086820","바이오솔루션","11170","9930","-1240","-11.10","437771","4451937430"
"038460","바이오스마트","3255","3330","75","2.30","7935341","27395495185"
"251120","바이오에프디엔씨","15550","14550","-1000","-6.43","1163073","17440150620"
"199730","바이오인프라","20200","15480","-4720","-23.37","1451429","24193232530"
"266470","바이오인프라생명과학","489","373","-116","-23.72","198456","82492084"
"086040","바이오톡스텍","7000","7460","460","6.57","8454855","63212623080"
"199290","바이오프로테크","1294","1298","4","0.31","30870","38695033"
"099430","바이오플러스","6950","7480","530","7.63","43631889","335698876840"
"032980","바이온","1815","1637","-178","-9.81","22814143","38139658989"
"222160","바이옵트로","7370","6480","-890","-12.08","10725274","85623297650"
"308080","바이젠셀","6620","6120","-500","-7.55","1481979","9281523710"
"043150","바텍","39400","38000","-1400","-3.55","3556280","135606813900"
"323990","박셀바이오","33550","31850","-1700","-5.07","10478119","370044400600"
"003610","방림","2430","2360","-70","-2.88","9823996","23657851855"
"267790","배럴","8000","7210","-790","-9.88","675140","5024504880"
"001340","백광산업","7540","7790","250","3.32","15638788","125510995840"
"046310","백금T&A","3450","3920","470","13.62","12752010","46578026080"
"035150","백산","8150","7930","-220","-2.70","2257869","17908014630"
"331520","밸로프","1169","1264","95","8.13","65204563","94092702532"
"066410","버킷스튜디오","1153","1153","0","0.00","0","0"
"002410","범양건영","2925","2530","-395","-13.50","4410990","12578258985"
"382900","범한퓨얼셀","27500","23800","-3700","-13.45","1132470","28424959650"
"206400","베노티앤알","4190","4450","260","6.21","5179089","20438359080"
"019010","베뉴지","2255","2240","-15","-0.67","3740756","8590579900"
"322190","베른","180","159","-21","-11.67","87478","12987434"
"177350","베셀","5220","4840","-380","-7.28","7370952","37343555325"
"299910","베스파","3165","3165","0","0.00","0","0"
"424760","벨로크","2355","2290","-65","-2.76","1007662","2393286080"
"007210","벽산","2215","2590","375","16.93","11013584","26236630515"
"225530","보광산업","6180","6100","-80","-1.29","2513341","15446390010"
"250000","보라티알","15850","13640","-2210","-13.94","2439285","36373359600"
"002760","보락","1591","1490","-101","-6.35","12360527","19432658659"
"003850","보령","7760","9110","1350","17.40","5693519","47406829810"
"310210","보로노이","46268","72700","26432","57.13","5146820","298099785450"
"006910","보성파워텍","3555","3370","-185","-5.20","39678030","154884498980"
"000890","보해양조","593","524","-69","-11.64","9202911","5035801324"
"226340","본느","1694","2105","411","24.26","68111745","148349098409"
"206950","볼빅","2135","2135","0","0.00","0","0"
"003000","부광약품","6970","7070","100","1.43","2737189","18616980970"
"001270","부국증권","21400","21900","500","2.34","24282","520885200"
"001275","부국증권우","19070","18880","-190","-1.00","7507","141862060"
"026940","부국철강","3355","3300","-55","-1.64","1885185","6145724055"
"014470","부방","2380","2630","250","10.50","21880087","54435324475"
"011390","부산산업","71900","67500","-4400","-6.12","95651","6718922600"
"005030","부산주공","486","486","0","0.00","0","0"
"008470","부스타","5030","4805","-225","-4.47","200576","973670935"
"338220","뷰노","31700","34400","2700","8.52","25784975","962849947050"
"100120","뷰웍스","34750","31050","-3700","-10.65","463177","15212634850"
"337930","브랜드엑스코퍼레이션","5190","5000","-190","-3.66","6034333","30921390520"
"099390","브레인즈컴퍼니","8280","7530","-750","-9.06","2179245","18736719350"
"064480","브리지텍","7790","7550","-240","-3.08","6148156","48464070700"
"288330","브릿지바이오테라퓨틱스","4800","6730","1930","40.21","4814128","27395096240"
"365900","브이씨","5430","4840","-590","-10.87","1647113","9169888940"
"251630","브이원텍","12770","12750","-20","-0.16","5549158","68367647350"
"018290","브이티","9380","9730","350","3.73","29774348","276598028780"
"044480","블레이드 Ent","1318","1277","-41","-3.11","3150583","4285035338"
"033560","블루콤","3670","3580","-90","-2.45","3058001","10906538985"
"191600","블루탑","10500","11000","500","4.76","384","3967980"
"369370","블리츠웨이","1653","1721","68","4.11","1396812","2319212372"
"126340","비나텍","66700","56700","-10000","-14.99","1561173","99162471300"
"121800","비덴트","3320","3320","0","0.00","0","0"
"148140","비디아이","640","640","0","0.00","0","0"
"082800","비보존 제약","674","626","-48","-7.12","22169585","14563539710"
"318410","비비씨","9950","10080","130","1.31","235104","2352489820"
"002070","비비안","1671","1384","-287","-17.18","13202825","20954581988"
"100220","비상교육","5290","4580","-710","-13.42","2576865","12303428935"
"419540","비스토스","2725","2445","-280","-10.28","24861608","65904745035"
"146320","비씨엔씨","20700","16790","-3910","-18.89","3836959","78400070890"
"200780","비씨월드제약","6520","6740","220","3.37","420598","2664348280"
"141000","비아트론","9260","9950","690","7.45","4183599","42238200150"
"090460","비에이치","28100","22900","-5200","-18.51","12092838","310657346000"
"083650","비에이치아이","8000","7200","-800","-10.00","37114354","347106836810"
"445360","비엔케이제1호스팩","2075","2060","-15","-0.72","576450","1186276295"
"142760","비엘","3215","3085","-130","-4.04","7212892","21735137325"
"065170","비엘팜텍","698","628","-70","-10.03","15750759","10271887839"
"086220","비엘헬스케어","2055","1989","-66","-3.21","11285","22147039"
"086670","비엠티","16290","16100","-190","-1.17","2110276","34234164990"
"335890","비올","7320","8430","1110","15.16","52090044","397496398260"
"138580","비즈니스온","10780","11250","470","4.36","745147","7968804890"
"082920","비츠로셀","22000","19450","-2550","-11.59","8218646","174604577120"
"054220","비츠로시스","617","541","-76","-12.32","19460671","11395814845"
"042370","비츠로테크","8450","8250","-200","-2.37","56471769","511152003960"
"030790","비케이탑스","904","904","0","0.00","0","0"
"050090","비케이홀딩스","1421","1300","-121","-8.52","1448474","1959610781"
"307870","비투엔","2200","3700","1500","68.18","51921013","173749983050"
"357880","비트나인","7580","7010","-570","-7.52","11901171","100663229200"
"032850","비트컴퓨터","6610","6060","-550","-8.32","2381162","14688280560"
"148780","비플라이소프트","1079","1035","-44","-4.08","5561724","6028082649"
"238200","비피도","6600","6700","100","1.52","484274","3071950950"
"093190","빅솔론","6180","5590","-590","-9.55","852427","4939743580"
"065450","빅텍","4595","4140","-455","-9.90","8247231","37210116885"
"210120","빅텐츠","24300","28500","4200","17.28","230386","7628145850"
"005180","빙그레","45450","45900","450","0.99","641349","28598536300"
"072950","빛샘전자","4845","4770","-75","-1.55","706650","3375801140"
"266170","뿌리깊은나무들","849","799","-50","-5.89","14146","11182002"
"143240","사람인","19170","18780","-390","-2.03","1086768","21100840350"
"003960","사조대림","25200","26750","1550","6.15","800422","19910914450"
"008040","사조동아원","1036","1015","-21","-2.03","80855865","92682410906"
"007160","사조산업","39250","41150","1900","4.84","155387","6165035750"
"014710","사조씨푸드","4665","4300","-365","-7.82","982468","4238205460"
"006090","사조오양","8210","8190","-20","-0.24","203152","1651936040"
"419120","산돌","10840","9390","-1450","-13.38","570694","5551796560"
"122350","삼기","2985","2410","-575","-19.26","8919192","23206317000"
"419050","삼기이브이","16440","13850","-2590","-15.75","8664662","139466306910"
"014970","삼륭물산","4460","3890","-570","-12.78","349097","1396879400"
"018310","삼목에스폼","14990","15740","750","5.00","586212","8985777580"
"012210","삼미금속","1639","1499","-140","-8.54","7457","12200813"
"053700","삼보모터스","7280","6030","-1250","-17.17","14256644","96922016040"
"009620","삼보산업","1070","1002","-68","-6.36","5226981","5259449549"
"023600","삼보판지","9030","9500","470","5.20","657846","6069768000"
"001470","삼부토건","3530","3465","-65","-1.84","1096020335","4831529338950"
"448730","삼성FN리츠","5070","5010","-60","-1.18","2858631","14378426900"
"006400","삼성SDI","703000","634000","-69000","-9.82","6391565","4340238093695"
"006405","삼성SDI우","327000","304000","-23000","-7.03","146473","47294770000"
"006660","삼성공조","11890","10200","-1690","-14.21","709514","7291760970"
"380320","삼성머스트스팩5호","2870","2540","-330","-11.50","903505","2562943025"
"028260","삼성물산","102300","104000","1700","1.66","5694348","586971535400"
"02826K","삼성물산우B","90700","87600","-3100","-3.42","88816","7799117000"
"207940","삼성바이오로직스","749000","798000","49000","6.54","2063987","1572393060375"
"032830","삼성생명","66700","70900","4200","6.30","4761463","331948076500"
"377630","삼성스팩4호","3800","3555","-245","-6.45","3622900","14928860440"
"425290","삼성스팩6호","2975","2700","-275","-9.24","2200595","6435665845"
"439250","삼성스팩7호","9930","9810","-120","-1.21","312012","3073070450"
"448740","삼성스팩8호","9760","9710","-50","-0.51","366847","3567166290"
"018260","삼성에스디에스","117900","135700","17800","15.10","4903218","639048721900"
"028050","삼성엔지니어링","29100","35900","6800","23.37","34143509","1139700702167"
"009150","삼성전기","142800","151000","8200","5.74","13612225","2072278018900"
"009155","삼성전기우","66900","70600","3700","5.53","224124","15745599300"
"005930","삼성전자","71600","68900","-2700","-3.77","356706733","25102242223617"
"005935","삼성전자우","59100","56800","-2300","-3.89","25509634","1485052665990"
"001360","삼성제약","2995","2990","-5","-0.17","15065984","46671248850"
"010140","삼성중공업","7050","9130","2080","29.50","350380566","2958539539900"
"016360","삼성증권","35200","36350","1150","3.27","4650908","167176592150"
"068290","삼성출판사","20250","18500","-1750","-8.64","510072","9391482900"
"029780","삼성카드","28800","29300","500","1.74","1807469","52021111750"
"000810","삼성화재","223000","249000","26000","11.66","1841677","442841652609"
"000815","삼성화재우","169800","177100","7300","4.30","181014","31428063500"
"006110","삼아알미늄","104900","100500","-4400","-4.19","5231813","617090024400"
"009300","삼아제약","17430","18250","820","4.70","229555","3966824340"
"145990","삼양사","42000","40100","-1900","-4.52","388897","16153112350"
"145995","삼양사우","26050","24700","-1350","-5.18","15077","375961800"
"003230","삼양식품","121200","125500","4300","3.55","1312986","156321881800"
"225190","삼양옵틱스","9820","9710","-110","-1.12","295660","2851239330"
"002170","삼양통상","50100","50300","200","0.40","29001","1444951800"
"272550","삼양패키징","17380","16040","-1340","-7.71","309593","5098213860"
"000070","삼양홀딩스","72200","69800","-2400","-3.32","163328","11504158600"
"000075","삼양홀딩스우","54100","52400","-1700","-3.14","5120","267559200"
"003720","삼영","4270","4180","-90","-2.11","14796607","66452126475"
"002810","삼영무역","13070","12270","-800","-6.12","341524","4269448860"
"361670","삼영에스앤씨","6890","6210","-680","-9.87","267244","1733797610"
"054540","삼영엠텍","4390","4340","-50","-1.14","3345462","14806041815"
"065570","삼영이엔씨","5620","5340","-280","-4.98","5653586","33927472050"
"005680","삼영전자","9540","8860","-680","-7.13","1119821","10088271870"
"023000","삼원강재","3270","3160","-110","-3.36","8012515","28158089495"
"004380","삼익THK","12750","12290","-460","-3.61","901715","11124090660"
"002450","삼익악기","1197","1126","-71","-5.93","3207103","3616473848"
"032280","삼일","2095","1949","-146","-6.97","1387379","2824095317"
"002290","삼일기업공사","3470","3440","-30","-0.86","964245","3279857635"
"004440","삼일씨엔에스","5300","4415","-885","-16.70","1003644","4588551225"
"000520","삼일제약","7440","7610","170","2.28","4859809","35381504760"
"009770","삼정펄프","27400","26450","-950","-3.47","41321","1095815850"
"037460","삼지전자","8470","7740","-730","-8.62","691864","5404191740"
"032750","삼진","6270","6180","-90","-1.44","3916975","24974338170"
"054090","삼진엘앤디","2575","2280","-295","-11.46","4570664","11048377805"
"005500","삼진제약","21800","23200","1400","6.42","1989920","44831006150"
"000250","삼천당제약","51000","65300","14300","28.04","8835894","543036553450"
"004690","삼천리","106200","115200","9000","8.47","794795","85553663600"
"024950","삼천리자전거","5960","6140","180","3.02","7933240","55416275400"
"038500","삼표시멘트","3245","3385","140","4.31","5735112","19188913015"
"017480","삼현철강","5450","5110","-340","-6.24","554871","2896214485"
"010960","삼호개발","3580","3420","-160","-4.47","787966","2785666880"
"046390","삼화네트웍스","2240","2160","-80","-3.57","6639648","14260341606"
"004450","삼화왕관","35400","34950","-450","-1.27","607937","23163659150"
"009470","삼화전기","21650","18610","-3040","-14.04","6661069","148054520840"
"011230","삼화전자","8390","6810","-1580","-18.83","51897206","495365711020"
"001820","삼화콘덴서","42750","41000","-1750","-4.09","2144066","91493475600"
"000390","삼화페인트","6200","6250","50","0.81","4008473","26522698510"
"027580","상보","2095","1793","-302","-14.42","307318241","632724968748"
"038540","상상인","4105","4160","55","1.34","4640115","19531344395"
"101000","상상인인더스트리","1800","1990","190","10.56","1107552","1974133753"
"415580","상상인제3호스팩","2235","2285","50","2.24","589725","1313145480"
"001290","상상인증권","786","732","-54","-6.87","1104445","814097523"
"041650","상신브레이크","3980","3780","-200","-5.03","16538118","66360951535"
"091580","상신이디피","19730","18280","-1450","-7.35","9023404","183759672910"
"263810","상신전자","5640","4570","-1070","-18.97","5746211","29358182100"
"089980","상아프론테크","26800","25050","-1750","-6.53","2277376","58827677300"
"042940","상지카일룸","503","485","-18","-3.58","25647427","13753971073"
"042600","새로닉스","40400","37150","-3250","-8.04","6296644","279049788050"
"075180","새론오토모티브","4805","4565","-240","-4.99","190278","903509330"
"107600","새빗켐","83100","87900","4800","5.78","5344930","520122616600"
"411080","샌즈랩","10210","9330","-880","-8.62","1386426","13528548660"
"252990","샘씨엔에스","6370","5560","-810","-12.72","17791238","111936812070"
"007540","샘표","56900","51800","-5100","-8.96","477297","25577958150"
"248170","샘표식품","30350","27900","-2450","-8.07","637266","18346722700"
"378800","샤페론","4215","4355","140","3.32","48117244","226698197370"
"294630","서남","3185","7170","3985","125.12","255964102","2383267214460"
"038070","서린바이오","11400","10690","-710","-6.23","1042128","10921949540"
"006730","서부T&D","8150","8430","280","3.44","8480136","69552153100"
"079650","서산","1924","1789","-135","-7.02","564986","974902588"
"100660","서암기계공업","5600","5070","-530","-9.46","2727169","14608306580"
"007860","서연","9660","8360","-1300","-13.46","3683510","33905168690"
"200880","서연이화","24100","21700","-2400","-9.96","22198865","561606483380"
"019770","서연탑메탈","4590","4180","-410","-8.93","3837140","16815514605"
"017390","서울가스","67600","69900","2300","3.40","471193","31695917800"
"043710","서울리거","924","920","-4","-0.43","3801750","3421313134"
"092190","서울바이오시스","4980","4660","-320","-6.43","1469906","7017727810"
"046890","서울반도체","12460","11560","-900","-7.22","10115604","122141448130"
"004410","서울식품","206","199","-7","-3.40","43801318","8825378617"
"004415","서울식품우","2260","2000","-260","-11.50","119073","247985565"
"063170","서울옥션","13100","12160","-940","-7.18","2719732","33097795610"
"027040","서울전자통신","555","505","-50","-9.01","2114878","1104646681"
"018680","서울제약","4330","4220","-110","-2.54","280956","1146092670"
"021050","서원","1379","1796","417","30.24","333115556","734632476241"
"093920","서원인텍","5980","5970","-10","-0.17","1089897","6489131170"
"189860","서전기전","5470","4880","-590","-10.79","5949909","36185007875"
"178320","서진시스템","19260","15730","-3530","-18.33","11941560","204545359460"
"122690","서진오토모티브","4150","3740","-410","-9.88","5406981","20868302780"
"140070","서플러스글로벌","4090","3960","-130","-3.18","4074626","16214276070"
"011370","서한","1020","988","-32","-3.14","6028486","5997132785"
"065710","서호전기","18200","18790","590","3.24","152904","2882342340"
"008490","서흥","26550","26900","350","1.32","347646","9632104050"
"035890","서희건설","1490","1333","-157","-10.54","22107503","31968404478"
"357550","석경에이티","53700","52200","-1500","-2.79","5370502","309313908700"
"003100","선광","20650","20800","150","0.73","1575046","31299708050"
"007610","선도전기","3000","3000","0","0.00","0","0"
"067370","선바이오","10150","9820","-330","-3.25","579081","5527308510"
"171090","선익시스템","27850","24250","-3600","-12.93","2960042","78375045650"
"136490","선진","8360","8220","-140","-1.67","1059493","8639280510"
"086710","선진뷰티사이언스","9940","9740","-200","-2.01","3693828","33589345330"
"014620","성광벤드","15530","16900","1370","8.82","12950914","209975213770"
"037350","성도이엔지","4405","4180","-225","-5.11","8523885","39995646925"
"014910","성문전자","2075","1709","-366","-17.64","8274610","15424345776"
"014915","성문전자우","8020","5890","-2130","-26.56","30818","199993910"
"003080","성보화학","3300","3110","-190","-5.76","1184885","3645711275"
"004980","성신양회","8530","9730","1200","14.07","3425494","31278535580"
"004985","성신양회우","12800","12790","-10","-0.08","132438","1665998010"
"011300","성안","2300","2280","-20","-0.87","42396682","102200288700"
"081580","성우전자","2635","2530","-105","-3.98","19388781","55266630860"
"045300","성우테크론","4575","4660","85","1.86","19282725","108736281895"
"015750","성우하이텍","13520","11150","-2370","-17.53","163565162","2285778694280"
"365340","성일하이텍","134200","131600","-2600","-1.94","7467409","1076188518300"
"000180","성창기업지주","2060","2010","-50","-2.43","2801556","5559768600"
"080470","성창오토텍","6570","5790","-780","-11.87","416828","2555464100"
"043260","성호전자","1687","1609","-78","-4.62","11860075","19258805684"
"148150","세경하이테크","18850","16510","-2340","-12.41","1515218","26977690190"
"002420","세기상사","7310","6530","-780","-10.67","178068","1233601810"
"053060","세동","2660","2420","-240","-9.02","12130560","29504372805"
"340440","세림B&G","2355","2150","-205","-8.70","5859024","13797835345"
"017510","세명전기","3355","3045","-310","-9.24","1115750","3488464860"
"004360","세방","12000","11950","-50","-0.42","3367130","39140556960"
"004365","세방우","7350","6720","-630","-8.57","57401","404079530"
"004490","세방전지","48400","48300","-100","-0.21","2078348","99504327700"
"011560","세보엠이씨","9750","9010","-740","-7.59","864145","8125110670"
"396300","세아메카닉스","5440","4660","-780","-14.34","6557134","33732219100"
"001430","세아베스틸지주","25550","24700","-850","-3.33","5427380","149743502200"
"306200","세아제강","150900","151300","400","0.27","294224","45535417500"
"003030","세아제강지주","195100","191500","-3600","-1.85","298384","58853263800"
"019440","세아특수강","15840","15120","-720","-4.55","1075066","17259602670"
"058650","세아홀딩스","113300","111800","-1500","-1.32","6763","749632400"
"013000","세우글로벌","1430","1297","-133","-9.30","2397800","3155411421"
"100700","세운메디칼","2705","2660","-45","-1.66","1377492","3605882790"
"024830","세원물산","8330","7260","-1070","-12.85","305595","2430898430"
"091090","세원이앤씨","254","254","0","0.00","0","0"
"021820","세원정공","9010","7410","-1600","-17.76","489273","3962893670"
"067830","세이브존I&C","2695","2610","-85","-3.15","624136","1639268295"
"033530","세종공업","9430","7330","-2100","-22.27","6142881","51693599440"
"258830","세종메디칼","1830","1378","-452","-24.70","17724851","27586167526"
"036630","세종텔레콤","593","580","-13","-2.19","12948589","7700878577"
"039310","세중","2460","2305","-155","-6.30","838053","1954177285"
"075580","세진중공업","6270","6110","-160","-2.55","11234573","74982687170"
"067770","세진티에스","3285","2905","-380","-11.57","865930","2633473105"
"053450","세코닉스","8810","7530","-1280","-14.53","3553117","28501091980"
"222810","세토피아","3030","2795","-235","-7.76","33914461","102752321500"
"027970","세하","1285","1312","27","2.10","2522429","3206984471"
"252500","세화피앤씨","1065","968","-97","-9.11","2534424","2490670035"
"347000","센코","3430","3545","115","3.35","29047073","96380907070"
"331920","셀레믹스","4580","4620","40","0.87","904101","4154842690"
"049180","셀루메드","4060","3840","-220","-5.42","11756214","44697917105"
"299660","셀리드","5777","6710","933","16.15","3864436","26214035940"
"268600","셀리버리","6680","6680","0","0.00","0","0"
"108860","셀바스AI","17080","23400","6320","37.00","110269864","2515762121380"
"208370","셀바스헬스케어","6720","9870","3150","46.88","88899386","785719356990"
"318160","셀바이오휴먼텍","5600","4830","-770","-13.75","7756193","46353252030"
"258250","셀젠텍","4995","3990","-1005","-20.12","79101","338156855"
"068270","셀트리온","152600","154900","2300","1.51","14579483","2181720709900"
"068760","셀트리온제약","71900","89700","17800","24.76","20665902","1790312250300"
"091990","셀트리온헬스케어","63200","69800","6600","10.44","29462006","1928944551200"
"068940","셀피글로벌","778","778","0","0.00","0","0"
"060230","소니드","4865","4030","-835","-17.16","30249130","137763064870"
"290690","소룩스","30100","19120","-10980","-36.48","13419578","285634161690"
"950200","소마젠","6440","6310","-130","-2.02","848948","5240001590"
"032680","소프트센","886","743","-143","-16.14","73706205","62946987440"
"032685","소프트센우","11000","10050","-950","-8.64","46075","444578420"
"258790","소프트캠프","1602","1612","10","0.62","16004886","28814070222"
"066910","손오공","1878","2710","832","44.30","22470081","55773311402"
"043100","솔고바이오","497","461","-36","-7.24","5805893","2745088225"
"336370","솔루스첨단소재","37850","34000","-3850","-10.17","5177364","184941989400"
"33637K","솔루스첨단소재1우","8390","7260","-1130","-13.47","448791","3493591500"
"33637L","솔루스첨단소재2우B","10080","9230","-850","-8.43","96880","980753470"
"248070","솔루엠","28100","28300","200","0.71","20464313","580644704900"
"035610","솔본","4610","4155","-455","-9.87","2369128","10306615365"
"357780","솔브레인","245500","260000","14500","5.91","1147470","306197508500"
"036830","솔브레인홀딩스","26300","25150","-1150","-4.37","1082733","28824398300"
"304100","솔트룩스","21150","39500","18350","86.76","55898076","2042028210300"
"328380","솔트웨어","1711","1625","-86","-5.03","129588180","233207569826"
"004430","송원산업","18050","18140","90","0.50","2807934","52132505790"
"086980","쇼박스","3680","3340","-340","-9.24","8181185","29117585085"
"050960","수산아이앤티","10150","9530","-620","-6.11","323589","3103802480"
"126720","수산인더스트리","21750","19740","-2010","-9.24","1020117","21517283830"
"017550","수산중공업","2720","2480","-240","-8.82","10496148","28225472960"
"084180","수성샐바시온","930","919","-11","-1.18","33869385","33217573051"
"253840","수젠텍","6810","7700","890","13.07","6798014","55192098830"
"185190","수프로","880","1000","120","13.64","20470","20338112"
"298830","슈어소프트테크","10180","8650","-1530","-15.03","28758144","289898190770"
"236200","슈프리마","22400","21850","-550","-2.46","847351","18368051000"
"094840","슈프리마에이치큐","7550","7100","-450","-5.96","2054003","14429689530"
"192440","슈피겐코리아","35000","34050","-950","-2.71","217677","7573678250"
"136510","스마트솔루션즈","11600","11600","0","0.00","0","0"
"099440","스맥","2215","2630","415","18.74","23148690","53381990278"
"053210","스카이라이프","6380","6500","120","1.88","1273351","7932636080"
"033790","스카이문스테크놀로지","1639","1629","-10","-0.61","5617416","9265589222"
"276040","스코넥","11000","9020","-1980","-18.00","2733773","26813953650"
"159910","스킨앤스킨","137","118","-19","-13.87","93203390","11857681865"
"115570","스타플렉스","4205","3820","-385","-9.16","704153","2791072800"
"330730","스톤브릿지벤처스","3945","3970","25","0.63","643569","2498109365"
"253450","스튜디오드래곤","49800","51800","2000","4.02","3719594","188114583650"
"408900","스튜디오미르","31900","27700","-4200","-13.17","798373","23174519812"
"204630","스튜디오산타클로스","412","617","205","49.76","83468000","41167168515"
"026890","스틱인베스트먼트","6590","6670","80","1.21","4731511","31111300960"
"013810","스페코","4485","3950","-535","-11.93","8013272","37449041995"
"203690","스피어파워","8210","7110","-1100","-13.40","2122458","16250035920"
"049830","승일","11120","10250","-870","-7.82","224414","2415869650"
"020710","시공테크","4805","4545","-260","-5.41","12154982","65196886540"
"033170","시그네틱스","1551","1327","-224","-14.44","35260734","54077022996"
"048870","시너지이노베이션","2300","2085","-215","-9.35","6934799","14266574758"
"025320","시노펙스","3175","3300","125","3.94","41258538","137665685830"
"134790","시디즈","36150","35650","-500","-1.38","346412","12855916550"
"269620","시스웍","889","889","0","0.00","0","0"
"131090","시큐브","1032","1080","48","4.65","3124324","3226435418"
"232830","시큐센","5310","3495","-1815","-34.18","48844957","233043042540"
"139050","시티랩스","5690","5280","-410","-7.21","747111","3918300980"
"016590","신대양제지","5230","5500","270","5.16","4552556","25770918700"
"290520","신도기연","5610","4930","-680","-12.12","2090995","11089123035"
"029530","신도리코","34300","33500","-800","-2.33","169028","5569623950"
"004970","신라교역","9740","9070","-670","-6.88","366382","3370193460"
"001000","신라섬유","1945","1915","-30","-1.54","15954027","31932523224"
"025870","신라에스지","8480","8370","-110","-1.30","482936","3984352670"
"215600","신라젠","4775","4850","75","1.57","15829536","72239942430"
"065350","신성델타테크","10650","26600","15950","149.77","125928841","2782476638260"
"011930","신성이엔지","2545","2590","45","1.77","373847035","1022063883340"
"005390","신성통상","2015","1801","-214","-10.62","3367169","6360268968"
"004170","신세계","180900","193000","12100","6.69","1403819","268169338383"
"035510","신세계 I&C","12930","13700","770","5.96","1248129","16711721300"
"034300","신세계건설","16600","14750","-1850","-11.14","284910","4371674410"
"031430","신세계인터내셔날","16760","16630","-130","-0.78","2222734","36818641430"
"031440","신세계푸드","40600","41350","750","1.85","141576","5786359700"
"006880","신송홀딩스","10240","8540","-1700","-16.60","6230081","58402491620"
"162300","신스틸","5450","3600","-1850","-33.94","40172480","199351578460"
"002800","신신제약","4680","4960","280","5.98","5117833","26665781685"
"419270","신영스팩7호","2285","2210","-75","-3.28","350146","782774470"
"430220","신영스팩8호","2195","2125","-70","-3.19","279161","604719055"
"445970","신영스팩9호","2125","2090","-35","-1.65","561732","1178777825"
"005800","신영와코루","10400","9900","-500","-4.81","365622","3594086460"
"001720","신영증권","56500","56000","-500","-0.88","44527","2467186300"
"001725","신영증권우","54600","55100","500","0.92","12473","684406800"
"009270","신원","1430","1343","-87","-6.08","10528732","13766532002"
"017000","신원종합개발","4725","4850","125","2.65","22521252","127015276225"
"002700","신일전자","1860","1708","-152","-8.17","18816340","33256502091"
"012790","신일제약","7640","7340","-300","-3.93","1071695","7795134990"
"138070","신진에스엠","3005","2755","-250","-8.32","4694853","13183056435"
"226330","신테카바이오","10910","16640","5730","52.52","64871958","882833987820"
"002870","신풍","1029","953","-76","-7.39","1399368","1325365773"
"019170","신풍제약","15200","19140","3940","25.92","32080240","604805341390"
"019175","신풍제약우","27800","30950","3150","11.33","269698","8494870550"
"404990","신한서부티엔디리츠","3295","3080","-215","-6.53","1900790","6035172320"
"293940","신한알파리츠","6220","6240","20","0.32","2823072","17423509710"
"418210","신한제10호스팩","2280","2165","-115","-5.04","163797","361809650"
"366330","신한제7호스팩","5070","5390","320","6.31","7543685","42989386325"
"393360","신한제8호스팩","2325","2325","0","0.00","0","0"
"405640","신한제9호스팩","2300","2235","-65","-2.83","513999","1143130810"
"055550","신한지주","33050","35100","2050","6.20","27549805","944116619570"
"056700","신화인터텍","2675","2305","-370","-13.83","2906647","7053686950"
"187270","신화콘텍","5100","4670","-430","-8.43","2484777","11251196105"
"004080","신흥","14300","14000","-300","-2.10","143322","2021199290"
"243840","신흥에스이씨","47100","48250","1150","2.44","2449427","124427633650"
"257720","실리콘투","7770","8680","910","11.71","65717469","515500304590"
"222800","심텍","33550","36100","2550","7.60","21321754","762877699850"
"036710","심텍홀딩스","2950","2930","-20","-0.68","6378694","20083239425"
"160980","싸이맥스","13700","14230","530","3.87","1320712","18670573690"
"356890","싸이버원","9370","9630","260","2.77","1049008","10651952390"
"217330","싸이토젠","16440","16640","200","1.22","819690","13593178160"
"102280","쌍방울","269","269","0","0.00","0","0"
"003410","쌍용C&E","4875","5410","535","10.97","15472270","80205018340"
"010280","쌍용정보통신","870","844","-26","-2.99","6213501","5197791562"
"004770","써니전자","2295","2280","-15","-0.65","8439522","19267243235"
"217320","썬테크","6380","6370","-10","-0.16","1781","9947265"
"208640","썸에이지","477","427","-50","-10.48","16332048","6818456490"
"222420","쎄노텍","2045","1899","-146","-7.14","12869101","25857794668"
"037760","쎄니트","1635","1555","-80","-4.89","1484259","2306886741"
"099320","쎄트렉아이","29450","27950","-1500","-5.09","706438","19938407800"
"015540","쎌마테라퓨틱스","6410","6410","0","0.00","0","0"
"049960","쎌바이오텍","12440","11470","-970","-7.80","254613","3001376690"
"403550","쏘카","14640","12670","-1970","-13.46","1077642","14377042250"
"050890","쏠리드","5310","5010","-300","-5.65","7474865","37708907685"
"066790","씨씨에스","553","517","-36","-6.51","3519631","1822955046"
"222080","씨아이에스","13920","11250","-2670","-19.18","38321231","505234631230"
"004920","씨아이테크","3230","2425","-805","-24.92","26095071","67652605520"
"236030","씨알푸드","6180","5580","-600","-9.71","156","782070"
"103660","씨앗","2985","2860","-125","-4.19","169269","432141560"
"352480","씨앤씨인터내셔널","49000","54700","5700","11.63","4186051","202647332400"
"245450","씨앤에스링크","1598","1599","1","0.06","50","80093"
"264660","씨앤지하이테크","13000","13500","500","3.85","1413650","20023435320"
"352700","씨앤투스","3940","3835","-105","-2.66","2441264","9051205025"
"297090","씨에스베어링","13770","12300","-1470","-10.68","8923443","116834145420"
"112610","씨에스윈드","83600","72000","-11600","-13.88","10298462","804446584885"
"359090","씨엔알리서치","1251","1264","13","1.04","11955683","15863163546"
"286000","씨엔티드림","3050","3050","0","0.00","0","0"
"115530","씨엔플러스","480","425","-55","-11.46","7405715","3364673075"
"115480","씨유메디칼","1249","1173","-76","-6.08","10001916","12144279426"
"340810","씨유박스","12150","10080","-2070","-17.04","3591147","39923901250"
"376290","씨유테크","4290","3945","-345","-8.04","520200","2139534700"
"189330","씨이랩","15220","13840","-1380","-9.07","1660901","24884387810"
"096530","씨젠","19900","22700","2800","14.07","32133009","766172418350"
"900120","씨케이에이치","154","140","-14","-9.09","44605939","6261728702"
"101240","씨큐브","6420","5750","-670","-10.44","2521210","15569056220"
"060590","씨티씨바이오","9760","10530","770","7.89","3053306","29570635710"
"308170","씨티알모빌리티","15930","13570","-2360","-14.81","997143","14838440330"
"260930","씨티케이","6800","6020","-780","-11.47","2025905","13045600270"
"013990","아가방컴퍼니","3315","3025","-290","-8.75","3135805","9612748530"
"123860","아나패스","20050","24300","4250","21.20","1340527","31442495250"
"025980","아난티","7310","6730","-580","-7.93","13365370","91732918300"
"008700","아남전자","1996","2175","179","8.97","54931556","117249646833"
"058220","아리온","275","275","0","0.00","0","0"
"125210","아모그린텍","17760","14220","-3540","-19.93","10806932","176385070970"
"002790","아모레G","25500","29000","3500","13.73","7848265","221875741300"
"00279K","아모레G3우(전환)","19540","20350","810","4.15","174195","3476289390"
"002795","아모레G우","10100","9920","-180","-1.78","429644","4277277060"
"090430","아모레퍼시픽","95000","121100","26100","27.47","8899392","981280871600"
"090435","아모레퍼시픽우","30300","36600","6300","20.79","372889","12627874000"
"357580","아모센스","16000","14620","-1380","-8.63","1711397","25596402200"
"052710","아모텍","11960","9990","-1970","-16.47","19097929","224911857810"
"074430","아미노로직스","1530","1467","-63","-4.12","3503126","5108007726"
"092040","아미코젠","18470","17760","-710","-3.84","2510608","44767775830"
"083930","아바코","21800","17860","-3940","-18.07","13605443","275125162220"
"149950","아바텍","15110","14160","-950","-6.29","334208","4936974230"
"036010","아비코전자","16440","15120","-1320","-8.03","11678552","198053251050"
"002030","아세아","140100","170300","30200","21.56","136395","20965713700"
"183190","아세아시멘트","9400","10010","610","6.49","2629751","25242922970"
"002310","아세아제지","33750","38850","5100","15.11","1441759","55804064950"
"050860","아세아텍","2830","2545","-285","-10.07","2923916","7720828235"
"012170","아센디오","843","695","-148","-17.56","12305208","9734059949"
"136410","아셈스","9970","7830","-2140","-21.46","1204852","10433606610"
"246720","아스타","9190","8020","-1170","-12.73","6168624","62004214630"
"067390","아스트","2635","1645","-990","-37.57","25154859","46750876666"
"159010","아스플로","14410","12860","-1550","-10.76","3378325","49459767100"
"127710","아시아경제","1472","1303","-169","-11.48","7146948","9462274059"
"267850","아시아나IDT","13100","12500","-600","-4.58","356876","4414703560"
"020560","아시아나항공","11950","11150","-800","-6.69","4682799","53342492450"
"154030","아시아종묘","3650","3410","-240","-6.58","3900207","14802136000"
"227610","아우딘퓨쳐스","4150","2180","-1970","-47.47","29706823","107846527620"
"143160","아이디스","20000","21200","1200","6.00","959176","18314225610"
"054800","아이디스홀딩스","12410","12360","-50","-0.40","67402","828790780"
"332370","아이디피","3875","3655","-220","-5.68","860098","3262966260"
"122900","아이마켓코리아","9730","9070","-660","-6.78","1147499","10681143480"
"339950","아이비김영","2025","1853","-172","-8.49","4895375","9418515961"
"099190","아이센스","23500","29400","5900","25.11","35061364","1139048060500"
"289010","아이스크림에듀","4415","4225","-190","-4.30","1063151","4577901025"
"214430","아이쓰리시스템","31000","35900","4900","15.81","3797047","131414848600"
"040910","아이씨디","10650","9120","-1530","-14.37","1455962","14486689920"
"368600","아이씨에이치","6150","5060","-1090","-17.72","7550498","46698987630"
"052860","아이앤씨","2795","2770","-25","-0.89","4304657","12948057175"
"010780","아이에스동서","31700","32400","700","2.21","3785996","126380207950"
"069920","아이에스이커머스","3555","3510","-45","-1.27","4607435","15206251690"
"038880","아이에이","586","531","-55","-9.39","38692140","21892942836"
"307180","아이엘사이언스","3830","3970","140","3.66","6551976","27661214790"
"101390","아이엠","6770","6820","50","0.74","5104237","33787977870"
"447690","아이오바이오","2795","4725","1930","69.05","9008","28047430"
"078860","아이오케이","244","247","3","1.23","121366286","42874545374"
"090150","아이윈","1606","1665","59","3.67","9074045","14253222753"
"123010","아이윈플러스","2180","1845","-335","-15.37","5712757","11325070412"
"031310","아이즈비전","2985","2895","-90","-3.02","5816021","16976323290"
"185490","아이진","3905","3745","-160","-4.10","2784951","10049434395"
"059100","아이컴포넌트","6730","6250","-480","-7.13","869677","6072927230"
"149010","아이케이세미콘","9450","8050","-1400","-14.81","31896","276819770"
"262840","아이퀘스트","6970","6340","-630","-9.04","346709","2270434330"
"175250","아이큐어","2655","2625","-30","-1.13","7444620","19178458850"
"052460","아이크래프트","4230","3365","-865","-20.45","5610743","21705592455"
"119830","아이텍","9810","10080","270","2.75","3930791","37794086530"
"052770","아이톡시","1397","1495","98","7.02","26213066","45646653612"
"124500","아이티센","3810","3725","-85","-2.23","2592805","9927553815"
"372800","아이티아이즈","9250","8240","-1010","-10.92","433283","3746613650"
"084850","아이티엠반도체","21150","22700","1550","7.33","953196","20226308930"
"114840","아이패밀리에스씨","26750","22750","-4000","-14.95","2508044","58344369130"
"027360","아주IB투자","2180","2275","95","4.36","6227827","13701795535"
"139990","아주스틸","9390","8500","-890","-9.48","801905","7068685910"
"032080","아즈텍WB","1765","1738","-27","-1.53","3409488","5851795854"
"013310","아진산업","7550","5830","-1720","-22.78","54966416","380200102880"
"059120","아진엑스텍","9290","9030","-260","-2.80","7847406","78407360040"
"158430","아톤","20250","19780","-470","-2.32","508797","9906588850"
"149300","아퓨어스","649","498","-151","-23.27","410878","203810775"
"067160","아프리카TV","73800","84200","10400","14.09","7076652","537262742000"
"102950","아하","6660","6090","-570","-8.56","247252","1617429910"
"001540","안국약품","8140","8200","60","0.74","458206","3681598060"
"053800","안랩","61600","63000","1400","2.27","1523275","95684759100"
"251280","안지오랩","6980","8400","1420","20.34","9073","63342230"
"065660","안트로젠","15030","15150","120","0.80","735274","11120627890"
"297570","알로이스","1633","1629","-4","-0.24","3199911","4925011443"
"001780","알루코","4970","3925","-1045","-21.03","103996221","484117503865"
"260660","알리코제약","5710","5890","180","3.15","705904","3976388150"
"354320","알멕","134700","87700","-47000","-34.89","7085676","785504952000"
"361570","알비더블유","5410","4635","-775","-14.33","6160129","33249079760"
"131370","알서포트","3680","3295","-385","-10.46","2515741","8421321955"
"140670","알에스오토메이션","12380","13520","1140","9.21","3908577","51536380310"
"096610","알에프세미","17950","10450","-7500","-41.78","18820921","297536400440"
"061040","알에프텍","4405","3995","-410","-9.31","2859868","11625280890"
"148250","알엔투테크놀로지","7880","6000","-1880","-23.86","1051349","7138613820"
"347860","알체라","8610","15200","6590","76.54","51462615","702300954280"
"196170","알테오젠","38950","47450","8500","21.82","13491529","584062700850"
"123750","알톤스포츠","3740","3590","-150","-4.01","9130631","34332712700"
"085810","알티캐스트","1759","1564","-195","-11.09","2950918","4787018266"
"117670","알파홀딩스","945","945","0","0.00","0","0"
"314140","알피바이오","10600","10420","-180","-1.70","1232768","12584661310"
"291650","압타머사이언스","3975","4235","260","6.54","10228306","41827512805"
"293780","압타바이오","8770","10620","1850","21.09","9399909","91504454570"
"018250","애경산업","26700","23000","-3700","-13.86","2062262","51554101050"
"161000","애경케미칼","19700","17280","-2420","-12.28","56644376","1270361501510"
"390110","애니메디솔루션","3955","5040","1085","27.43","9264","38813225"
"196300","애니젠","14900","15420","520","3.49","941190","14501306420"
"310200","애니플러스","4035","3475","-560","-13.88","15109812","57049144820"
"179530","애드바이오텍","3935","3545","-390","-9.91","624274","2167639395"
"900100","애머릿지","2435","2185","-250","-10.27","3780549","8717369064"
"205500","액션스퀘어","2450","1728","-722","-29.47","5204369","11453785772"
"052790","액토즈소프트","6370","6350","-20","-0.31","432035","2636770780"
"290740","액트로","7300","7090","-210","-2.88","4075471","31509979270"
"238090","앤디포스","2310","2970","660","28.57","5305628","13974164840"
"092600","앤씨앤","1782","1550","-232","-13.02","2104233","3396893860"
"129890","앱코","3785","4135","350","9.25","7074950","28667325435"
"174900","앱클론","15450","17940","2490","16.12","3901068","67156300670"
"255440","야스","11070","9720","-1350","-12.20","958802","9886518040"
"030960","양지사","16700","18660","1960","11.74","33505256","646528823570"
"102120","어보브반도체","10450","9600","-850","-8.13","5845306","61261735820"
"263540","어스앤에어로스페이스","5950","5950","0","0.00","0","0"
"238120","얼라인드","8460","8500","40","0.47","1130433","9563354000"
"224810","엄지하우스","3740","3400","-340","-9.09","11264","38278220"
"019990","에너토크","7820","6860","-960","-12.28","2066993","16458608420"
"011090","에넥스","660","617","-43","-6.52","3778104","2355438447"
"270660","에브리봇","14500","14490","-10","-0.07","2808785","39450768410"
"038680","에스넷","5140","4810","-330","-6.42","5148851","26752599815"
"137310","에스디바이오센서","11750","12780","1030","8.77","60980002","826327010160"
"217480","에스디생명공학","349","349","0","0.00","0","0"
"121890","에스디시스템","739","739","0","0.00","0","0"
"097780","에스맥","1157","1296","139","12.01","5203224","6153998866"
"304360","에스바이오메딕스","10050","9680","-370","-3.68","5929422","57145204260"
"389500","에스비비테크","36900","44250","7350","19.92","6434532","271965698450"
"042110","에스씨디","1588","1579","-9","-0.57","4874307","7336158108"
"298060","에스씨엠생명과학","6039","4920","-1119","-18.53","1498640","8515464210"
"065420","에스아이리소스","438","327","-111","-25.34","38231848","13057747501"
"270210","에스알바이오텍","4620","5380","760","16.45","156","708635"
"103230","에스앤더블류","6350","5430","-920","-14.49","8151676","51171604740"
"260970","에스앤디","14800","14320","-480","-3.24","137772","1967050450"
"101490","에스앤에스텍","52100","52300","200","0.38","14104543","783452242850"
"095910","에스에너지","2495","2190","-305","-12.22","2289845","5159350218"
"275630","에스에스알","4770","5380","610","12.79","1446133","7127883185"
"031330","에스에이엠티","3005","2790","-215","-7.15","6034067","17264908160"
"060540","에스에이티","2360","2310","-50","-2.12","4700390","10764130073"
"351320","에스에이티이엔지","3595","3160","-435","-12.10","1636013","5278112490"
"056190","에스에프에이","36100","37750","1650","4.57","4122705","150247829314"
"080000","에스엔유","3560","3260","-300","-8.43","6778667","22267987720"
"005850","에스엘","40000","34450","-5550","-13.88","6692441","256115043550"
"214310","에스엘에너지","306","306","0","0.00","0","0"
"246250","에스엘에스바이오","9980","9550","-430","-4.31","190311","1886638870"
"258540","에스엘테라퓨틱스","1065","774","-291","-27.32","426584","340500471"
"041510","에스엠","106700","135400","28700","26.90","9513807","1194996747500"
"010580","에스엠벡셀","2915","2370","-545","-18.70","22560990","59282633780"
"299670","에스엠비나","2700","1800","-900","-33.33","0","0"
"007820","에스엠코어","6390","6250","-140","-2.19","2480938","14859841950"
"109610","에스와이","5260","4085","-1175","-22.34","100425486","518325732015"
"012750","에스원","53000","55400","2400","4.53","1917305","102390148650"
"031860","에스유홀딩스","902","1216","314","34.81","121525294","129770241578"
"306040","에스제이그룹","12290","10530","-1760","-14.32","683384","7679880490"
"217910","에스제이켐","420","415","-5","-1.19","110120","42030845"
"224020","에스케이씨에스","1896","1599","-297","-15.66","73160","116885250"
"435870","에스케이증권제8호스팩","2345","2240","-105","-4.48","1294571","3110799575"
"096630","에스코넥","1734","1613","-121","-6.98","155509205","319339246346"
"069510","에스텍","7870","7980","110","1.40","162501","1264532470"
"041910","에스텍파마","7050","6790","-260","-3.69","1280137","8610789080"
"234300","에스트래픽","5400","4610","-790","-14.63","17794730","89398493005"
"039440","에스티아이","18590","25700","7110","38.25","30353749","794166745200"
"098660","에스티오","2525","2500","-25","-0.99","698077","1722771115"
"052020","에스티큐브","14790","13650","-1140","-7.71","8625467","118738712420"
"237690","에스티팜","73800","82200","8400","11.38","2634485","200462506600"
"050760","에스폴리텍","2355","2090","-265","-11.25","1059426","2292276281"
"288620","에스퓨얼셀","18530","17560","-970","-5.23","858571","15152855570"
"317830","에스피시스템스","15450","14470","-980","-6.34","15527283","243431387860"
"058610","에스피지","28700","32400","3700","12.89","21199865","675683674900"
"043340","에쎈테크","837","793","-44","-5.26","2984623","2330272617"
"023960","에쓰씨엔지니어링","1750","2190","440","25.14","50029269","106837393556"
"298690","에어부산","3350","2960","-390","-11.64","10530609","32159973760"
"187660","에이디엠코리아","2770","2315","-455","-16.43","10346815","26132727885"
"054630","에이디칩스","403","366","-37","-9.18","20624255","8042759321"
"200710","에이디테크놀로지","22450","23650","1200","5.35","22799224","580119325050"
"096690","에이루트","405","380","-25","-6.17","15176072","5830092815"
"140910","에이리츠","3945","3890","-55","-1.39","88139","325383080"
"078520","에이블씨엔씨","7130","7470","340","4.77","3929138","26677287030"
"298380","에이비엘바이오","19070","19490","420","2.20","11100137","211631456130"
"203400","에이비온","7490","8590","1100","14.69","2566277","18740354850"
"195990","에이비프로바이오","441","409","-32","-7.26","26690808","11239487354"
"003800","에이스침대","27150","25950","-1200","-4.42","54361","1433903400"
"088800","에이스테크","2594","2450","-144","-5.55","5457069","15206444800"
"241840","에이스토리","16960","15120","-1840","-10.85","1453796","22231918770"
"311960","에이아이더뉴트리진","15910","16800","890","5.59","59085","996222010"
"312610","에이에프더블류","4245","3855","-390","-9.19","2716922","10987500900"
"015260","에이엔피","1634","1532","-102","-6.24","2492658","3956264765"
"234070","에이원알폼","1399","1425","26","1.86","4703","7120331"
"072990","에이치시티","7400","8330","930","12.57","1507904","11993822230"
"227100","에이치앤비디자인","3805","3745","-60","-1.58","3202173","11643377060"
"044990","에이치엔에스하이텍","15090","13800","-1290","-8.55","91203","1288106780"
"239610","에이치엘사이언스","18310","15640","-2670","-14.58","447993","7578354920"
"353060","에이치엠씨제5호스팩","2090","2090","0","0.00","0","0"
"148930","에이치와이티씨","9600","9110","-490","-5.10","3185339","31129578130"
"044780","에이치케이","1910","1883","-27","-1.41","1788675","3288571862"
"357230","에이치피오","9580","9090","-490","-5.11","1893154","17002271580"
"071670","에이테크솔루션","11630","11200","-430","-3.70","3695547","44164155050"
"045660","에이텍","9870","9350","-520","-5.27","735772","6981546450"
"224110","에이텍모빌리티","14940","13240","-1700","-11.38","1224439","17310612290"
"230980","에이트원","1147","1018","-129","-11.25","16706184","18591033712"
"021080","에이티넘인베스트","2410","2805","395","16.39","15277717","38898227675"
"089530","에이티세미콘","600","600","0","0.00","0","0"
"200470","에이팩트","3950","3230","-720","-18.23","15627475","64590462900"
"207490","에이펙스인텍","7000","7000","0","0.00","5419","37919500"
"262260","에이프로","19450","17400","-2050","-10.54","12181624","243345061170"
"007460","에이프로젠","1138","1752","614","53.95","151448653","215678840359"
"109960","에이프로젠 H&G","1386","1714","328","23.67","12171882","18377273323"
"003060","에이프로젠바이오로직스","369","471","102","27.64","156120965","62644749531"
"397030","에이프릴바이오","21150","24000","2850","13.48","2509218","55008799470"
"244920","에이플러스에셋","4695","4525","-170","-3.62","1308218","5642013890"
"089970","에이피티씨","16430","16180","-250","-1.52","6064252","110835107760"
"230240","에치에프알","19310","21150","1840","9.53","3613620","75161302460"
"230360","에코마케팅","10070","10460","390","3.87","4943282","52894108510"
"038870","에코바이오","6150","5130","-1020","-16.59","3174865","17953060320"
"101360","에코앤드림","39950","32550","-7400","-18.52","8548706","333932716100"
"128540","에코캡","4300","3855","-445","-10.35","4555309","18831747640"
"086520","에코프로","941000","1127000","186000","19.77","31334971","35072308374000"
"247540","에코프로비엠","275000","343500","68500","24.91","76471464","29394831730500"
"383310","에코프로에이치엔","63400","115900","52500","82.81","61153123","5809655505200"
"038110","에코플라스틱","7350","5660","-1690","-22.99","43848207","297101830150"
"073540","에프알텍","2755","2550","-205","-7.44","562664","1451413235"
"064850","에프앤가이드","8150","7830","-320","-3.93","320029","2440804200"
"036810","에프에스티","18770","24550","5780","30.79","20656396","533149237520"
"173940","에프엔씨엔터","7920","6940","-980","-12.37","698706","5058088400"
"083500","에프엔에스테크","8900","9460","560","6.29","2827666","26522846130"
"054940","엑사이엔씨","1149","1076","-73","-6.35","8289343","9127041403"
"043090","엑서지21","948","676","-272","-28.69","26002841","18608440806"
"950130","엑세스바이오","7710","8880","1170","15.18","12154242","108925149140"
"205100","엑셈","4000","4050","50","1.25","11333124","46508361760"
"356680","엑스게이트","4980","4065","-915","-18.37","27194817","118079060435"
"070300","엑스큐어","3020","2865","-155","-5.13","410904","1221534220"
"317770","엑스페릭스","15810","8820","-6990","-44.21","19005227","212944606860"
"092870","엑시콘","13370","14230","860","6.43","5715752","83861811590"
"317870","엔바이오니아","14260","15830","1570","11.01","1385298","22148329450"
"067570","엔브이에이치코리아","3615","3300","-315","-8.71","4522581","16116735470"
"236810","엔비티","6750","7610","860","12.74","46940586","386272308160"
"140610","엔솔바이오사이언스","13050","11760","-1290","-9.89","128010","1567933550"
"333620","엔시스","14400","13250","-1150","-7.99","2185143","32126231440"
"101400","엔시트론","706","648","-58","-8.22","3812207","2578472117"
"036570","엔씨소프트","287500","262500","-25000","-8.70","2921254","810536799648"
"238170","엔에스엠","474","409","-65","-13.71","942054","356208878"
"224760","엔에스컴퍼니","4015","4000","-15","-0.37","24966","100488255"
"380440","엔에이치스팩19호","9980","10000","20","0.20","415474","4154605100"
"391060","엔에이치스팩20호","9960","10000","40","0.40","184033","1837577270"
"422040","엔에이치스팩23호","2190","2120","-70","-3.20","512638","1093471985"
"437780","엔에이치스팩24호","2180","2180","0","0.00","0","0"
"438580","엔에이치스팩25호","2430","2460","30","1.23","168525","416426040"
"439410","엔에이치스팩26호","2165","2075","-90","-4.16","886353","1855342220"
"440820","엔에이치스팩27호","2185","2095","-90","-4.12","510379","1084525860"
"450410","엔에이치스팩28호","2230","2230","0","0.00","0","0"
"451700","엔에이치스팩29호","2030","2015","-15","-0.74","1297366","2648764595"
"265740","엔에프씨","8890","7960","-930","-10.46","525419","4527879780"
"354200","엔젠바이오","6510","6630","120","1.84","1524731","10464680080"
"419080","엔젯","21250","20600","-650","-3.06","2524579","52747559200"
"093510","엔지브이아이","1620","1650","30","1.85","458","664589"
"208860","엔지스테크널러지","2205","2205","0","0.00","0","0"
"183490","엔지켐생명과학","1814","1569","-245","-13.51","7143800","11387094322"
"085310","엔케이","1030","1047","17","1.65","16116235","17166077838"
"182400","엔케이맥스","15710","13320","-2390","-15.21","11884257","169560861630"
"348370","엔켐","68500","64600","-3900","-5.69","10595762","748995968300"
"058450","엔터파트너즈","892","731","-161","-18.05","4140479","3492555614"
"069410","엔텔스","5330","4940","-390","-7.32","3208877","17476085315"
"227950","엔투텍","1079","868","-211","-19.56","28672481","26818033240"
"291230","엔피","4275","3620","-655","-15.32","26232460","101581482615"
"198080","엔피디","2135","2015","-120","-5.62","941676","1884169942"
"048830","엔피케이","2000","1889","-111","-5.55","1823618","3429738254"
"096870","엘디티","3650","3340","-310","-8.49","646947","2172355250"
"276240","엘리비젼","745","649","-96","-12.89","3541","2084660"
"900140","엘브이엠씨홀딩스","2360","2665","305","12.92","43047367","112083296095"
"138690","엘아이에스","2750","2750","0","0.00","0","0"
"290650","엘앤씨바이오","35550","38100","2550","7.17","9327477","349097373400"
"066970","엘앤에프","238500","224500","-14000","-5.87","42212278","11000556207806"
"156100","엘앤케이바이오","6070","7050","980","16.14","5727053","36858970760"
"311060","엘에이티","4800","5790","990","20.63","62863","338960840"
"073110","엘엠에스","7050","6380","-670","-9.50","1027963","6974677230"
"083310","엘오티베큠","16270","23650","7380","45.36","14268141","310011550960"
"037950","엘컴텍","1407","1440","33","2.35","87826289","126835493556"
"170920","엘티씨","10470","9760","-710","-6.78","4042044","42004192520"
"058630","엠게임","7030","7150","120","1.71","2835019","20475467590"
"058970","엠로","48000","70700","22700","47.29","14209037","1084758627950"
"019590","엠벤처투자","927","1004","77","8.31","12197483","11807899323"
"169330","엠브레인","3040","3025","-15","-0.49","721775","2198386365"
"097520","엠씨넥스","30800","27500","-3300","-10.71","2227266","63294037150"
"179290","엠아이텍","10660","10150","-510","-4.78","5131510","52940985340"
"009780","엠에스씨","7140","5910","-1230","-17.23","10532738","73972432650"
"123040","엠에스오토텍","5690","4780","-910","-15.99","6393829","33152132590"
"323230","엠에프엠코리아","875","994","119","13.60","14233350","13542200136"
"032790","엠젠솔루션","2950","2785","-165","-5.59","1370029","3823242970"
"033160","엠케이전자","14320","14220","-100","-0.70","10519277","159895195300"
"347890","엠투아이","8620","8410","-210","-2.44","2548373","21245152020"
"033310","엠투엔","4105","3950","-155","-3.78","1990840","7660270425"
"259630","엠플러스","12280","14770","2490","20.28","9202974","127933659780"
"115960","연우","14340","14320","-20","-0.14","587761","8459208890"
"060850","영림원소프트랩","8380","8450","70","0.84","1405409","12171108770"
"014440","영보화학","3735","3400","-335","-8.97","706239","2496577380"
"143540","영우디에스피","1194","1081","-113","-9.46","4057719","4520659282"
"111770","영원무역","63000","58600","-4400","-6.98","2379327","141166459400"
"009970","영원무역홀딩스","77800","76800","-1000","-1.29","326878","25085700800"
"003520","영진약품","2385","2590","205","8.60","12720012","31108579370"
"000670","영풍","542000","571000","29000","5.35","58328","33040259000"
"036560","영풍정밀","13150","13740","590","4.49","10416907","150885919870"
"006740","영풍제지","24500","48400","23900","97.55","59060826","2246203015810"
"012280","영화금속","1001","890","-111","-11.09","5462744","5096410573"
"265560","영화테크","10600","10350","-250","-2.36","1293174","13318333930"
"012160","영흥","756","675","-81","-10.71","2331495","1596574932"
"036000","예림당","2270","1983","-287","-12.64","758050","1574137812"
"250930","예선테크","997","922","-75","-7.52","2863808","2753658252"
"053280","예스24","4975","4740","-235","-4.72","1745093","8543624115"
"015360","예스코홀딩스","31900","32100","200","0.63","158749","5112912000"
"122640","예스티","12540","18670","6130","48.88","6756596","114550229210"
"900300","오가닉티코스메틱","172","159","-13","-7.56","112701760","19541080373"
"045060","오공","3225","3080","-145","-4.50","636865","1972067900"
"080520","오디텍","5020","5280","260","5.18","16952312","92701855575"
"007310","오뚜기","386000","369000","-17000","-4.40","193991","71313295000"
"039830","오로라","7420","7310","-110","-1.48","359188","2597708970"
"322310","오로스테크놀로지","23550","21450","-2100","-8.92","8136151","200624975400"
"046120","오르비텍","4300","4090","-210","-4.88","8201756","35048198980"
"014940","오리엔탈정공","3965","3730","-235","-5.93","5698047","22811267980"
"002630","오리엔트바이오","688","645","-43","-6.25","7077300","4576220213"
"065500","오리엔트정공","1525","1200","-325","-21.31","2726961","3702767680"
"271560","오리온","120000","116100","-3900","-3.25","1924299","226314338681"
"001800","오리온홀딩스","14290","14720","430","3.01","1670061","23765749230"
"010470","오리콤","12730","14230","1500","11.78","4123283","52738140550"
"417860","오브젠","37900","49450","11550","30.47","7111638","331502565200"
"352910","오비고","10700","9150","-1550","-14.49","1234977","11926543540"
"053980","오상자이엘","6290","5580","-710","-11.29","7385505","45834875710"
"052420","오성첨단소재","1424","1409","-15","-1.05","4819481","6573341494"
"241790","오션브릿지","16870","14640","-2230","-13.22","1712547","27050326280"
"039200","오스코텍","20950","33950","13000","62.05","17558411","513163766030"
"226400","오스테오닉","6300","6100","-200","-3.17","22894909","140189327545"
"031510","오스템","1604","1452","-152","-9.48","1281081","1913923783"
"048260","오스템임플란트","1880000","1900000","20000","1.06","34027","64651959000"
"368970","오에스피","6080","6000","-80","-1.32","1769485","10538959890"
"138080","오이솔루션","14910","13270","-1640","-11.00","1379386","19072843360"
"080580","오킨스전자","15270","5950","-9320","-61.03","30286096","208281847480"
"067170","오텍","5250","5100","-150","-2.86","5512529","30635848555"
"353590","오토앤","11110","9480","-1630","-14.67","1516722","15096569460"
"173130","오파스넷","12520","14060","1540","12.30","15570636","194186868530"
"440320","오픈놀","15290","9250","-6040","-39.50","36812934","400667437310"
"049480","오픈베이스","2720","2540","-180","-6.62","6339859","16676692750"
"394280","오픈엣지테크놀로지","18980","20250","1270","6.69","25467692","557499808790"
"309930","오하임아이엔티","4550","5950","1400","30.77","7111617","35102361475"
"244460","올리패스","2080","1856","-224","-10.77","9223628","17106322691"
"226950","올릭스","15070","16000","930","6.17","2206671","35072921710"
"057540","옴니시스템","1297","1115","-182","-14.03","14735075","17021254865"
"131030","옵투스제약","5320","5220","-100","-1.88","5303214","29975552135"
"082210","옵트론텍","2680","2390","-290","-10.82","2060113","5177066570"
"109080","옵티시스","13180","12260","-920","-6.98","2858652","36772574390"
"380540","옵티코어","1992","1425","-567","-28.46","7335920","11858333566"
"153710","옵티팜","7730","6650","-1080","-13.97","2172842","16911069460"
"321820","와이더플래닛","4995","4370","-625","-12.51","912089","3842205280"
"122990","와이솔","7070","6330","-740","-10.47","1539445","10203370490"
"112290","와이씨켐","12630","13000","370","2.93","3471860","47185591580"
"232140","와이아이케이","4320","3995","-325","-7.52","11651601","51785734815"
"065530","와이어블","2485","2060","-425","-17.10","11980727","28577908891"
"067900","와이엔텍","8790","10690","1900","21.62","8639567","89510900740"
"007530","와이엠","3595","3590","-5","-0.14","1615275","5512677770"
"155650","와이엠씨","6280","6740","460","7.32","35760578","263567058620"
"273640","와이엠텍","22450","19640","-2810","-12.52","2400838","51286011670"
"251370","와이엠티","12560","11870","-690","-5.49","899170","11394988860"
"066430","와이오엠","1115","1142","27","2.42","34052076","42364445376"
"193250","와이제이엠게임즈","1086","904","-182","-16.76","5789730","5572869902"
"273060","와이즈버즈","1288","1548","260","20.19","179478990","352020140339"
"019210","와이지-원","6420","5820","-600","-9.35","3223556","19579973810"
"122870","와이지엔터테인먼트","78600","81700","3100","3.94","13619331","1025911400800"
"011690","와이투솔루션","1255","829","-426","-33.94","64726749","64199860438"
"332570","와이팜","4060","4065","5","0.12","50609389","244510769425"
"079000","와토스코리아","5550","5110","-440","-7.93","268308","1428920775"
"070960","용평리조트","3060","3055","-5","-0.16","1546930","4702936415"
"316140","우리금융지주","11400","11420","20","0.18","67389214","783186726090"
"032820","우리기술","1409","1318","-91","-6.46","72270267","109445027257"
"041190","우리기술투자","3830","3635","-195","-5.09","19281808","72914747445"
"115440","우리넷","8370","8310","-60","-0.72","7066831","61299125240"
"046970","우리로","1387","1662","275","19.83","96623724","163932417636"
"082850","우리바이오","2350","2090","-260","-11.06","3694562","7775412454"
"298870","우리벤처파트너스","2515","2555","40","1.59","5993425","15509388320"
"215360","우리산업","24200","20450","-3750","-15.50","2023718","45372121510"
"072470","우리산업홀딩스","4920","4010","-910","-18.50","1210252","5357753280"
"073560","우리손에프앤지","1897","1772","-125","-6.59","6748578","12039958565"
"037400","우리엔터프라이즈","1585","1396","-189","-11.92","1735036","2486674086"
"153490","우리이앤엘","1229","1041","-188","-15.30","9718543","10868150275"
"010050","우리종금","713","707","-6","-0.84","46105793","33578721587"
"101170","우림피티에스","6850","6730","-120","-1.75","10317028","70783850910"
"006980","우성","22450","21600","-850","-3.79","350439","7238492120"
"066590","우수AMS","3410","2840","-570","-16.72","4654553","14127338430"
"017370","우신시스템","4065","9530","5465","134.44","37837606","287886085520"
"103840","우양","4990","5720","730","14.63","36767142","208205057460"
"046940","우원개발","3390","3555","165","4.87","16179567","57603124340"
"215380","우정바이오","2770","2710","-60","-2.17","875437","2385462015"
"065680","우주일렉트로","15450","15710","260","1.68","1268035","19077006300"
"105840","우진","8850","9550","700","7.91","28751966","301997724480"
"018620","우진비앤지","1400","1330","-70","-5.00","3285669","4569601405"
"010400","우진아이엔에스","6010","5590","-420","-6.99","363742","2034850055"
"049800","우진플라임","3895","3790","-105","-2.70","15415006","66762520565"
"016880","웅진","1343","1238","-105","-7.82","3859666","4868027692"
"095720","웅진씽크빅","2515","2375","-140","-5.57","5718625","13801193415"
"005820","원림","21650","21750","100","0.46","275008","6139797700"
"307280","원바이오젠","2275","2190","-85","-3.74","9311785","20146626458"
"032940","원익","3795","3680","-115","-3.03","1067281","3963223650"
"240810","원익IPS","31450","34350","2900","9.22","12704693","439952183750"
"074600","원익QnC","29150","27200","-1950","-6.69","7274450","210113441450"
"104830","원익머트리얼즈","30400","28300","-2100","-6.91","1803164","52726348850"
"014190","원익큐브","1900","1702","-198","-10.42","2429676","4302968765"
"217820","원익피앤이","8700","8510","-190","-2.18","175433743","1933923351860"
"030530","원익홀딩스","3740","3405","-335","-8.96","6117991","21532836650"
"012620","원일특강","10160","9300","-860","-8.46","209782","2011634230"
"382840","원준","21600","24500","2900","13.43","21042898","558230326500"
"336570","원텍","10820","12620","1800","16.64","34829973","389041168450"
"376980","원티드랩","12070","10670","-1400","-11.60","848420","9456705120"
"122830","원포유","1278","1297","19","1.49","459997","597039740"
"008370","원풍","4475","4100","-375","-8.38","2914049","13185141210"
"008290","원풍물산","1332","990","-342","-25.68","2273969","2543083963"
"101160","월덱스","25850","24800","-1050","-4.06","3548701","93234634300"
"064090","웨스트라이즈","1790","1721","-69","-3.85","323926","549145727"
"336060","웨이버스","1887","1678","-209","-11.08","171238227","346187807984"
"095270","웨이브일렉트로","6300","6200","-100","-1.59","1544891","9482530070"
"010600","웰바이오텍","2105","3385","1280","60.81","648994226","2334220809810"
"065950","웰크론","2800","3060","260","9.29","68415869","232064631155"
"076080","웰크론한텍","4620","4610","-10","-0.22","25528804","125340931660"
"043590","웰킵스하이텍","1498","1071","-427","-28.50","11824914","15747246740"
"196700","웹스","2335","2040","-295","-12.63","3505430","8089331627"
"069080","웹젠","13500","14850","1350","10.00","1729708","24521575150"
"053580","웹케시","11960","12850","890","7.44","1048123","13328250450"
"071460","위니아","1991","1724","-267","-13.41","3956502","7151851646"
"377460","위니아에이드","5600","5100","-500","-8.93","1099545","5845917160"
"044340","위닉스","10890","9970","-920","-8.45","1029910","11055785130"
"330350","위더스제약","6940","7320","380","5.48","1826705","13172696980"
"348350","위드텍","15660","14580","-1080","-6.90","1747372","26788871680"
"112040","위메이드","39250","41500","2250","5.73","10298733","409711508500"
"101730","위메이드맥스","9980","10300","320","3.21","4783352","48124673120"
"123420","위메이드플레이","9500","8700","-800","-8.42","1185515","10550609110"
"065370","위세아이텍","12960","11850","-1110","-8.56","1790761","22087035690"
"140660","위월드","1699","1300","-399","-23.48","1407","1904524"
"038620","위즈코프","885","894","9","1.02","8443031","7666073697"
"299900","위지윅스튜디오","3035","2985","-50","-1.65","63007071","209584459380"
"036090","위지트","827","723","-104","-12.58","32671096","26735837044"
"136540","윈스","12100","12650","550","4.55","1123792","14073946480"
"320000","윈텍","3075","2555","-520","-16.91","9910708","27836220620"
"097800","윈팩","1718","1699","-19","-1.11","22485992","40643580683"
"192390","윈하이텍","4420","3575","-845","-19.12","1997083","7897609060"
"313760","윌링스","11210","13570","2360","21.05","3081190","40448484650"
"008600","윌비스","574","507","-67","-11.67","4288128","2231714203"
"335870","윙스풋","2040","1899","-141","-6.91","1036580","1917517642"
"900340","윙입푸드","964","894","-70","-7.26","3020007","2771845758"
"033270","유나이티드제약","23700","29250","5550","23.42","3851759","103426620900"
"014830","유니드","62000","57700","-4300","-6.94","734454","43353948700"
"446070","유니드비티플러스","8500","9280","780","9.18","4011940","34977278530"
"036200","유니셈","8320","9680","1360","16.35","27021992","261319672590"
"018000","유니슨","2025","1661","-364","-17.98","21250429","38364805723"
"000910","유니온","7130","5840","-1290","-18.09","7298637","45810713750"
"047400","유니온머티리얼","4220","3630","-590","-13.98","49336220","195730499415"
"203450","유니온커뮤니티","3385","3080","-305","-9.01","4792465","16268685010"
"011330","유니켐","1320","2430","1110","84.09","57924332","109758494452"
"077500","유니퀘스트","15360","16010","650","4.23","14568365","227706130350"
"011320","유니크","5870","5510","-360","-6.13","1728207","9553568455"
"086390","유니테스트","14270","13700","-570","-3.99","9646073","141064104700"
"241690","유니테크노","4495","3880","-615","-13.68","2207984","8878755120"
"142210","유니트론텍","4425","4085","-340","-7.68","4978482","22078040595"
"121060","유니포인트","1060","992","-68","-6.42","62793","55432678"
"048430","유라테크","11540","9020","-2520","-21.84","10500912","114281677290"
"206650","유바이오로직스","6990","7550","560","8.01","5819774","41514276690"
"089850","유비벨록스","12700","16520","3820","30.08","2159231","30646669320"
"084440","유비온","1698","2175","477","28.09","80897252","160246725014"
"032620","유비케어","5640","5040","-600","-10.64","2911884","14831310525"
"264450","유비쿼스","14280","12920","-1360","-9.52","368856","4897318310"
"078070","유비쿼스홀딩스","13780","12490","-1290","-9.36","230146","3056858970"
"002920","유성기업","3180","2850","-330","-10.38","660223","1940416500"
"024800","유성티엔에스","2325","2100","-225","-9.68","746473","1605727718"
"000700","유수홀딩스","6060","5630","-430","-7.10","339183","1958243680"
"054930","유신","32500","33700","1200","3.69","10318836","406743969750"
"069330","유아이디","1405","1400","-5","-0.36","1843611","2695679769"
"049520","유아이엘","3965","5700","1735","43.76","11169696","59914035105"
"435380","유안타제10호스팩","2190","2075","-115","-5.25","417783","895280625"
"446150","유안타제12호스팩","2120","2060","-60","-2.83","366425","767446965"
"449020","유안타제13호스팩","2060","2035","-25","-1.21","667713","1363226995"
"367480","유안타제8호스팩","3600","3505","-95","-2.64","8555745","32564442730"
"430700","유안타제9호스팩","2220","2090","-130","-5.86","338324","727258620"
"003470","유안타증권","2665","2650","-15","-0.56","3683730","9710823705"
"003475","유안타증권우","2715","2550","-165","-6.08","155224","400168220"
"263770","유에스티","3925","4115","190","4.84","2804614","11471354185"
"337840","유엑스엔","19450","22000","2550","13.11","126883","2721462510"
"072130","유엔젤","3620","3440","-180","-4.97","8134033","30384061695"
"000220","유유제약","5020","4965","-55","-1.10","1300248","6364193900"
"000225","유유제약1우","5600","4910","-690","-12.32","435412","2163544920"
"000227","유유제약2우B","11660","10690","-970","-8.32","18761","195604420"
"388720","유일로보틱스","21900","23900","2000","9.13","3219884","74746146900"
"340930","유일에너테크","17530","16900","-630","-3.59","3322003","59226020490"
"023410","유진기업","3390","3430","40","1.18","2126924","7183474045"
"056080","유진로봇","5520","9090","3570","64.67","100675339","840929211935"
"373340","유진스팩6호","2520","2520","0","0.00","0","0"
"388800","유진스팩7호","2350","2320","-30","-1.28","518334","1194972875"
"413630","유진스팩8호","2220","2115","-105","-4.73","492256","1063368410"
"442130","유진스팩9호","2220","2180","-40","-1.80","291284","639479605"
"084370","유진테크","31150","32050","900","2.89","7692347","256602891750"
"001200","유진투자증권","4220","3855","-365","-8.65","22929251","90544844985"
"221800","유투바이오","9170","8550","-620","-6.76","184483","1625237700"
"179900","유티아이","18320","19150","830","4.53","962095","19313556220"
"263050","유틸렉스","3620","3690","70","1.93","5008091","18695284310"
"000100","유한양행","58000","78100","20100","34.66","16275054","1124259415000"
"000105","유한양행우","54100","63800","9700","17.93","97197","5726613200"
"003460","유화증권","2435","2360","-75","-3.08","378750","892386650"
"003465","유화증권우","2520","2515","-5","-0.20","18034","44311875"
"191410","육일씨엔에쓰","3935","3780","-155","-3.94","1660368","6159269410"
"372170","윤성에프앤씨","179100","196000","16900","9.44","4628464","990698821000"
"008730","율촌화학","29900","33450","3550","11.87","3865370","136761307700"
"072770","율호","3070","2450","-620","-20.20","36615651","117072936450"
"008250","이건산업","7660","7050","-610","-7.96","785246","5715029180"
"039020","이건홀딩스","3090","2985","-105","-3.40","3894422","12713527415"
"025820","이구산업","4740","5430","690","14.56","182921346","1083410996345"
"067920","이글루","6960","6860","-100","-1.44","1484242","9993539580"
"044960","이글벳","5200","5290","90","1.73","10369160","56166470810"
"303530","이노뎁","12300","11200","-1100","-8.94","1792781","22917011710"
"296640","이노룰스","8970","8400","-570","-6.35","1201808","10396302770"
"302430","이노메트리","14950","16210","1260","8.43","2177058","35880173310"
"279060","이노벡스","3290","4345","1055","32.07","184239","737565430"
"214320","이노션","38600","41300","2700","6.99","739927","30054523300"
"274400","이노시뮬레이션","35000","14110","-20890","-59.69","23643365","555133374960"
"056090","이노시스","1180","1180","0","0.00","0","0"
"073490","이노와이어리스","26250","22200","-4050","-15.43","943877","22016930800"
"215790","이노인스트루먼트","1857","1498","-359","-19.33","88125135","181460953100"
"344860","이노진","3150","2990","-160","-5.08","861229","2677112825"
"246960","이노테라피","8430","9290","860","10.20","1301321","11127726660"
"088390","이녹스","33200","33050","-150","-0.45","3378897","124865199950"
"272290","이녹스첨단소재","37600","41350","3750","9.97","15822447","717861187100"
"053350","이니텍","3545","3500","-45","-1.27","489544","1633671350"
"041520","이라이콤","7000","8900","1900","27.14","11479141","112966643090"
"264850","이랜시스","2740","2435","-305","-11.13","3417029","8538231060"
"054210","이랜텍","11990","13390","1400","11.68","13750933","187699746640"
"164060","이루다","10170","9710","-460","-4.52","22397392","215548910340"
"065440","이루온","2280","2025","-255","-11.18","7952250","17020360396"
"088260","이리츠코크렙","5110","5010","-100","-1.96","796039","4041243845"
"139480","이마트","75000","81000","6000","8.00","3354801","258435192000"
"115610","이미지스","2605","3110","505","19.39","42487927","120743004280"
"078020","이베스트투자증권","4275","4075","-200","-4.68","1063099","4213369455"
"131400","이브이첨단소재","6670","4900","-1770","-26.54","87719291","531286238940"
"419700","이브이파킹서비스","1955","1008","-947","-48.44","1661166","1584378395"
"208850","이비테크","5500","6760","1260","22.91","329","1979510"
"351330","이삭엔지니어링","9970","8900","-1070","-10.73","991200","9223619510"
"080010","이상네트웍스","5620","5480","-140","-2.49","515136","2821897510"
"379390","이성씨엔아이","10890","9490","-1400","-12.86","534","5629720"
"457190","이수스페셜티케미컬","312500","216500","-96000","-30.72","6203241","1831301088400"
"086890","이수앱지스","6230","6910","680","10.91","12126832","83920648760"
"007660","이수페타시스","29450","31200","1750","5.94","256796826","9221333237750"
"005950","이수화학","26200","20400","-5800","-22.14","16618705","398692674150"
"015020","이스타코","894","793","-101","-11.30","3052270","2375830926"
"047560","이스트소프트","13160","17150","3990","30.32","22718988","382285514960"
"900110","이스트아시아홀딩스","151","135","-16","-10.60","86790588","12209049180"
"067010","이씨에스","3615","3290","-325","-8.99","1290319","4444299750"
"093230","이아이디","1392","1392","0","0.00","0","0"
"341310","이앤에치","900","839","-61","-6.78","45434","32946290"
"102710","이엔에프테크놀로지","25300","22150","-3150","-12.45","2031564","49180582950"
"066980","이엔코퍼레이션","3230","3065","-165","-5.11","8760844","29894300780"
"074610","이엔플러스","8880","6990","-1890","-21.28","50015977","404531959830"
"063760","이엘피","3555","3670","115","3.23","15021726","62536035755"
"123570","이엠넷","3490","3550","60","1.72","60036627","273575996940"
"083470","이엠앤아이","3210","2830","-380","-11.84","12964056","34117055695"
"095190","이엠코리아","2710","2625","-85","-3.14","8239144","23073030185"
"091120","이엠텍","32100","42550","10450","32.55","10984378","412451569000"
"232530","이엠티","4750","3270","-1480","-31.16","251860","929934185"
"102460","이연제약","16180","16450","270","1.67","1043064","16564216990"
"039030","이오테크닉스","110000","152700","42700","38.82","8936126","1286204868400"
"294090","이오플로우","28150","24950","-3200","-11.37","6898944","187580774800"
"088290","이원컴포텍","4400","3710","-690","-15.68","8139346","35570651385"
"084680","이월드","1468","1330","-138","-9.40","3274778","4451380627"
"181340","이즈미디어","2705","2705","0","0.00","0","0"
"353810","이지바이오","3735","3585","-150","-4.02","2281826","8355594720"
"350520","이지스레지던스리츠","3810","3635","-175","-4.59","365841","1355592280"
"334890","이지스밸류리츠","4495","4430","-65","-1.45","1258409","5611447835"
"099750","이지케어텍","21700","19860","-1840","-8.48","903405","18853303860"
"377330","이지트로닉스","10560","9900","-660","-6.25","1223634","12879426950"
"035810","이지홀딩스","3020","2850","-170","-5.63","3576991","10462804485"
"160600","이큐셀","3100","3100","0","0.00","0","0"
"092130","이크레더블","15630","14320","-1310","-8.38","202966","2984688030"
"096040","이트론","271","271","0","0.00","0","0"
"134060","이퓨쳐","6370","5910","-460","-7.22","371455","2281255595"
"001840","이화공영","3905","4430","525","13.44","37015999","172865266815"
"000760","이화산업","19280","17210","-2070","-10.74","264964","4727263460"
"024810","이화전기","899","899","0","0.00","0","0"
"014990","인디에프","1100","952","-148","-13.45","25664632","27408771924"
"041830","인바디","29200","27550","-1650","-5.65","851462","23622145450"
"352940","인바이오","4970","5030","60","1.21","2069796","10887014355"
"101140","인바이오젠","467","467","0","0.00","0","0"
"216400","인바이츠바이오코아","10490","10250","-240","-2.29","70757","728782670"
"079950","인베니아","1571","1439","-132","-8.40","5530445","8859150801"
"389470","인벤티지랩","9100","20200","11100","121.98","45345267","736280232160"
"277410","인산가","2425","2290","-135","-5.57","42377782","97731900336"
"060150","인선이엔티","8250","9370","1120","13.58","19902071","176540232980"
"033230","인성정보","3545","3080","-465","-13.12","67922760","253198491095"
"006490","인스코비","1393","1265","-128","-9.19","10591458","13794127105"
"037330","인지디스플레","2190","2050","-140","-6.39","23094079","52723366877"
"100030","인지소프트","19880","18120","-1760","-8.85","417480","7688594880"
"023800","인지컨트롤스","9710","9100","-610","-6.28","27581051","278053790560"
"034590","인천도시가스","25650","25550","-100","-0.39","41453","1051115400"
"211050","인카금융서비스","15160","15150","-10","-0.07","738602","11553655330"
"083640","인콘","653","576","-77","-11.79","12852675","7794307307"
"216050","인크로스","14100","12040","-2060","-14.61","6327198","87490237090"
"049070","인탑스","30850","29650","-1200","-3.89","7197946","217298317700"
"119610","인터로조","34900","33300","-1600","-4.58","1568019","53134951400"
"017250","인터엠","1533","1505","-28","-1.83","1082912","1591065591"
"129260","인터지스","2570","2400","-170","-6.61","1932786","4886724750"
"051370","인터플렉스","11780","10570","-1210","-10.27","4317091","49912927390"
"064290","인텍플러스","31850","36900","5050","15.86","14258322","581373342900"
"189300","인텔리안테크","70100","80200","10100","14.41","2514077","186039455600"
"150840","인트로메딕","5850","5850","0","0.00","0","0"
"048530","인트론바이오","6080","6090","10","0.16","3731502","22535357740"
"023810","인팩","12800","12220","-580","-4.53","5519285","72781593730"
"175140","인포마크","11010","12340","1330","12.08","1733869","19022578170"
"115310","인포바인","22200","20500","-1700","-7.66","335298","6892080160"
"039290","인포뱅크","11570","11010","-560","-4.84","2284832","27380617820"
"071200","인피니트헬스케어","5770","5670","-100","-1.73","3420912","19746757810"
"101930","인화정공","12250","11220","-1030","-8.41","721600","8772220490"
"249420","일동제약","14870","18260","3390","22.80","10858477","186377533980"
"000230","일동홀딩스","8500","12430","3930","46.24","11303528","131246021280"
"013360","일성건설","2080","1679","-401","-19.28","5746595","11067454234"
"003120","일성신약","25450","24000","-1450","-5.70","168174","4122003350"
"333430","일승","4200","4295","95","2.26","45561138","217452153440"
"068330","일신바이오","1750","1590","-160","-9.14","2639068","4251169306"
"003200","일신방직","10100","9750","-350","-3.47","589139","5752103930"
"007110","일신석재","1295","1194","-101","-7.80","9032406","11329631434"
"007570","일양약품","16630","17080","450","2.71","989247","16383970700"
"007575","일양약품우","17400","15210","-2190","-12.59","28131","441175770"
"178780","일월지엠엘","8650","8650","0","0.00","0","0"
"008500","일정실업","12900","12900","0","0.00","0","0"
"019540","일지테크","4840","4090","-750","-15.50","2800019","12346895520"
"081000","일진다이아","19330","16700","-2630","-13.61","799979","14203023330"
"020760","일진디스플","1358","1180","-178","-13.11","3939809","4755661951"
"103590","일진전기","10480","9690","-790","-7.54","49757606","543310288488"
"094820","일진파워","12880","12580","-300","-2.33","8265574","113514490550"
"271940","일진하이솔루스","31250","25200","-6050","-19.36","2403123","65974738150"
"015860","일진홀딩스","4600","4185","-415","-9.02","3334104","14510766240"
"226320","잇츠한불","14700","12760","-1940","-13.20","595864","7792554200"
"950140","잉글우드랩","9670","10300","630","6.51","8807525","87528923560"
"049550","잉크테크","4760","4210","-550","-11.55","831273","3768239455"
"389020","자람테크놀로지","34300","31900","-2400","-7.00","1446821","46518969050"
"254120","자비스","3015","4060","1045","34.66","84707693","421380983435"
"043910","자연과환경","1298","1425","127","9.78","345566093","514209687912"
"234920","자이글","16230","15710","-520","-3.20","9472391","165567216480"
"289220","자이언트스텝","14140","13120","-1020","-7.21","3024971","42599486300"
"317400","자이에스앤디","6190","5360","-830","-13.41","2262161","13119382460"
"033240","자화전자","33000","27350","-5650","-17.12","4410438","129463677800"
"174880","장원테크","530","530","0","0.00","0","0"
"049630","재영솔루텍","644","620","-24","-3.73","7059695","4484366527"
"417840","저스템","18050","14740","-3310","-18.34","3688952","63815711010"
"000950","전방","27550","26200","-1350","-4.90","29771","764852900"
"110020","전진바이오팜","4750","5340","590","12.42","4177798","22677210500"
"208140","정다운","2600","2395","-205","-7.88","4529488","10815202950"
"040420","정상제이엘에스","7200","7200","0","0.00","262863","1877774200"
"045510","정원엔시스","1350","1295","-55","-4.07","775537","980065294"
"217190","제너셈","13270","14490","1220","9.19","3229234","50132878150"
"095700","제넥신","9660","10240","580","6.00","5857591","56205693550"
"072520","제넨바이오","641","563","-78","-12.17","15761463","10387198942"
"122310","제노레이","7170","6840","-330","-4.60","527392","3627734400"
"361390","제노코","19210","16520","-2690","-14.00","1008774","17651108970"
"066830","제노텍","2595","2400","-195","-7.51","77236","195938390"
"187420","제노포커스","4235","3900","-335","-7.91","1156279","4541347715"
"225220","제놀루션","4030","4485","455","11.29","2513140","10762421445"
"123330","제닉","4510","4120","-390","-8.65","709747","2919018790"
"159580","제로투세븐","6200","5480","-720","-11.61","1370520","7852492310"
"147830","제룡산업","4630","4475","-155","-3.35","5780585","26236338765"
"033100","제룡전기","19800","22850","3050","15.40","9745932","204060597740"
"079370","제우스","35700","43500","7800","21.85","20445480","975565382950"
"054950","제이브이엠","27450","34700","7250","26.41","9532850","325340838700"
"023440","제이스코홀딩스","2550","2610","60","2.35","81410164","246876372080"
"090470","제이스텍","9380","8550","-830","-8.85","3856615","36088692210"
"287410","제이시스메디칼","9860","11370","1510","15.31","26843254","295835055240"
"137950","제이씨케미칼","8250","8150","-100","-1.21","6884459","57280173250"
"033320","제이씨현시스템","5130","4675","-455","-8.87","5712146","27563886530"
"417500","제이아이테크","5450","4840","-610","-11.19","21300762","105185662655"
"348950","제이알글로벌리츠","4120","3900","-220","-5.34","7469679","30246912625"
"204270","제이앤티씨","7810","8920","1110","14.21","4866496","44209399410"
"194370","제이에스코퍼레이션","13880","12880","-1000","-7.20","775123","10313103320"
"026040","제이에스티나","2670","2320","-350","-13.11","822757","1965469210"
"126880","제이엔케이히터","6780","6070","-710","-10.47","6666744","42911016230"
"322510","제이엘케이","16650","33750","17100","102.70","33999742","957810580880"
"254160","제이엠멀티","2230","2900","670","30.04","11869","28120387"
"033050","제이엠아이","1247","1130","-117","-9.38","8566637","11200345083"
"094970","제이엠티","3410","3325","-85","-2.49","2465630","8486169605"
"418550","제이오","32300","27750","-4550","-14.09","22972267","788774710100"
"025620","제이준코스메틱","6700","5870","-830","-12.39","332247","2048790140"
"089790","제이티","10660","8650","-2010","-18.86","6500319","66959505460"
"030000","제일기획","18110","19150","1040","5.74","10721560","195984556665"
"052670","제일바이오","1733","2080","347","20.02","5136813","11088195360"
"271980","제일약품","18490","18010","-480","-2.60","390274","6991755880"
"001560","제일연마","8290","7760","-530","-6.39","190863","1485560070"
"199820","제일전기공업","13790","12360","-1430","-10.37","3819079","51768277120"
"038010","제일테크노스","10410","8900","-1510","-14.51","4445945","42376465870"
"002620","제일파마홀딩스","13000","11610","-1390","-10.69","272051","3251394990"
"276730","제주맥주","1398","1208","-190","-13.59","6047181","8109133216"
"080220","제주반도체","4770","4300","-470","-9.85","14783594","70054862250"
"006220","제주은행","14370","9400","-4970","-34.59","14165014","162346886070"
"089590","제주항공","15100","13020","-2080","-13.77","8744216","122105741650"
"216080","제테마","22600","23450","850","3.76","4347949","109316319300"
"229000","젠큐릭스","3145","4350","1205","38.31","21718544","88092460705"
"248020","젬","2595","2500","-95","-3.66","1030","2376900"
"082270","젬백스","13250","12680","-570","-4.30","3778374","48351381440"
"064800","젬백스링크","1210","1113","-97","-8.02","3987790","4372435186"
"044060","조광ILI","732","732","0","0.00","0","0"
"004910","조광페인트","6760","6970","210","3.11","912370","5915699440"
"004700","조광피혁","48500","49750","1250","2.58","22974","1128221400"
"001550","조비","14540","14750","210","1.44","2122824","34386179280"
"120030","조선선재","102100","109000","6900","6.76","502672","59163352100"
"034940","조아제약","2100","1880","-220","-10.48","2005109","3826214307"
"067000","조이시티","3515","3190","-325","-9.25","6656566","21647215320"
"018470","조일알미늄","3055","3070","15","0.49","336458313","1181127697270"
"002600","조흥","197900","196700","-1200","-0.61","3559","704398300"
"185750","종근당","78800","85100","6300","7.99","877368","69032844000"
"063160","종근당바이오","23550","23100","-450","-1.91","255583","5744724050"
"001630","종근당홀딩스","47500","54700","7200","15.16","106563","5320222250"
"033340","좋은사람들","2110","2110","0","0.00","0","0"
"036930","주성엔지니어링","18150","25950","7800","42.98","90174054","2172907413590"
"044380","주연테크","704","616","-88","-12.50","4910368","3212104743"
"239340","줌인터넷","3295","3045","-250","-7.59","3552476","11001048685"
"051980","중앙디앤엠","4050","3010","-1040","-25.68","17043736","61271648770"
"072020","중앙백신","10740","11380","640","5.96","1409171","15832999500"
"000440","중앙에너비스","18240","18600","360","1.97","403722","7350378350"
"228760","지노믹트리","14900","22350","7450","50.00","30661717","534345110730"
"314130","지놈앤컴퍼니","16360","14710","-1650","-10.09","1680045","24246120800"
"013890","지누스","25550","26400","850","3.33","1243514","31148628650"
"389030","지니너스","3665","5630","1965","53.62","165850554","784991869235"
"043610","지니뮤직","3700","3660","-40","-1.08","5796044","21091939710"
"263860","지니언스","12200","12330","130","1.07","2130389","28434831840"
"303030","지니틱스","1591","1393","-198","-12.45","3130012","4458811086"
"036180","지더블유바이텍","750","835","85","11.33","49081854","43302428223"
"208350","지란지교시큐리티","3940","3965","25","0.63","1758204","7283966120"
"289860","지슨","4455","4240","-215","-4.83","45527","191890435"
"144510","지씨셀","37000","39300","2300","6.22","1518946","57094708250"
"358570","지아이이노베이션","17130","23850","6720","39.23","11702767","253001137680"
"382480","지아이텍","4740","4145","-595","-12.55","36617539","175644036885"
"382800","지앤비에스 에코","20100","23000","2900","14.43","2971965","65848581570"
"299480","지앤이헬스케어","780","777","-3","-0.38","11","8776"
"051160","지어소프트","6930","7480","550","7.94","7252915","56413381520"
"053050","지에스이","3500","3095","-405","-11.57","6639405","21207194910"
"388610","지에프씨생명과학","4706","4815","109","2.32","41767","561571115"
"119850","지엔씨에너지","4660","4140","-520","-11.16","3837012","16622957060"
"065060","지엔코","415","454","39","9.40","11426836","4887416078"
"204840","지엘팜텍","767","775","8","1.04","46409703","43327726210"
"013870","지엠비코리아","5140","4650","-490","-9.53","2253188","11128577225"
"071320","지역난방공사","27100","25750","-1350","-4.98","162246","4119971300"
"270520","지오릿에너지","11040","9810","-1230","-11.14","39629329","392039839880"
"311320","지오엘리먼트","13750","11840","-1910","-13.89","6865096","97136809590"
"388050","지투파워","11700","10170","-1530","-13.08","24580865","302026010090"
"219750","지티지웰니스","2850","2850","0","0.00","0","0"
"088790","진도","2555","2445","-110","-4.31","725279","1795845090"
"018120","진로발효","15600","14500","-1100","-7.05","94785","1353888010"
"109820","진매트릭스","3560","3720","160","4.49","3784696","14066904275"
"086060","진바이오텍","4245","4110","-135","-3.18","18361912","89763087975"
"036890","진성티이씨","12380","14320","1940","15.67","29803925","450292034130"
"363250","진시스템","29150","24150","-5000","-17.15","3608442","93508563300"
"003780","진양산업","6170","6200","30","0.49","1726144","11138109880"
"007370","진양제약","6150","5920","-230","-3.74","470579","2737478560"
"010640","진양폴리","4825","5160","335","6.94","9271627","52800344370"
"100250","진양홀딩스","3210","3345","135","4.21","2048956","6759985480"
"051630","진양화학","3260","3075","-185","-5.67","2808352","9495483100"
"272450","진에어","16410","14250","-2160","-13.16","4417241","67562731550"
"285800","진영","6110","5610","-500","-8.18","27628839","152604604980"
"011000","진원생명과학","3630","4795","1165","32.09","41304035","177554257210"
"250030","진코스텍","3695","3800","105","2.84","9859","34973775"
"002780","진흥기업","1251","1175","-76","-6.08","9813719","11886637185"
"002787","진흥기업2우B","12300","11090","-1210","-9.84","20484","235339000"
"002785","진흥기업우B","5200","4305","-895","-17.21","18967","88914030"
"233990","질경이","530","480","-50","-9.43","86275","41280834"
"085660","차바이오텍","13160","13690","530","4.03","7379685","95327700110"
"261780","차백신연구소","4720","5150","430","9.11","13330966","70215773830"
"009310","참엔지니어링","672","577","-95","-14.14","12751153","8000149608"
"094850","참좋은여행","8600","8630","30","0.35","1535804","13898946530"
"004650","창해에탄올","10360","10220","-140","-1.35","451763","4541177040"
"278280","천보","184300","171700","-12600","-6.84","2670708","503581104500"
"000650","천일고속","51300","49000","-2300","-4.48","5989","294492600"
"362320","청담글로벌","7070","6880","-190","-2.69","5153014","37772678830"
"012600","청호ICT","2490","2490","0","0.00","0","0"
"066360","체리부로","1618","1625","7","0.43","13690166","23850293929"
"033250","체시스","996","889","-107","-10.74","3131874","2935374572"
"047820","초록뱀미디어","5400","5400","0","0.00","0","0"
"131100","초록뱀이앤엠","2325","2100","-225","-9.68","2034927","4588029474"
"052300","초록뱀컴퍼니","350","361","11","3.14","14080663","4902278487"
"094360","칩스앤미디어","37600","37850","250","0.66","15903786","652297132200"
"016790","카나리아바이오","7721","5440","-2281","-29.54","49817110","597346158480"
"016920","카스","1573","1512","-61","-3.88","3344809","5094948676"
"284620","카이노스메드","3960","4350","390","9.85","2391481","10278943340"
"446600","카이바이오텍","24600","23000","-1600","-6.50","43","989000"
"035720","카카오","50900","52800","1900","3.73","51513345","2657469912250"
"293490","카카오게임즈","30550","30450","-100","-0.33","15557219","484847319350"
"323410","카카오뱅크","23050","28050","5000","21.69","46166019","1255466405500"
"377300","카카오페이","46400","48000","1600","3.45","7937337","395820483700"
"042000","카페24","15010","12040","-2970","-19.79","11725710","172470953510"
"006380","카프로","753","1400","647","85.92","61459527","80919919240"
"317530","캐리소프트","6470","5530","-940","-14.53","1135430","6600963190"
"071850","캐스텍코리아","2305","2050","-255","-11.06","1549880","3310938754"
"050110","캠시스","1564","1562","-2","-0.13","14863544","22941387987"
"119860","커넥트웨이브","12310","11140","-1170","-9.50","3120491","38864432720"
"223310","커머스마이너","2085","2000","-85","-4.08","3998297","8344982194"
"109070","컨버즈","4100","4100","0","0.00","0","0"
"900310","컬러레이","1186","1208","22","1.85","81689479","105626082613"
"078340","컴투스","56400","51600","-4800","-8.51","2928187","158082903500"
"063080","컴투스홀딩스","36050","32600","-3450","-9.57","935367","31037232950"
"307930","컴퍼니케이","7040","5980","-1060","-15.06","39837629","349770399760"
"079190","케스피온","1173","1003","-170","-14.49","4962366","5160845331"
"263700","케어랩스","6000","5420","-580","-9.67","2043637","11056575280"
"214370","케어젠","242500","203000","-39500","-16.29","1497180","332881082700"
"221980","케이디켐","13750","13100","-650","-4.73","242549","3371997310"
"038530","케이바이오","393","367","-26","-6.62","31223238","11624518880"
"001620","케이비아이동국실업","640","587","-53","-8.28","6234827","3830938536"
"424140","케이비제21호스팩","2090","2055","-35","-1.67","530264","1096046410"
"436530","케이비제22호스팩","2170","2170","0","0.00","0","0"
"440200","케이비제23호스팩","2180","1978","-202","-9.27","4415876","9139247668"
"192250","케이사인","1466","1553","87","5.93","15629801","23328193969"
"029460","케이씨","19580","18630","-950","-4.85","669102","12603085080"
"115500","케이씨에스","7250","7390","140","1.93","9073152","70203172420"
"281820","케이씨텍","21450","22300","850","3.96","2426331","54119532400"
"089150","케이씨티","3335","2850","-485","-14.54","974766","2922494320"
"025880","케이씨피드","2650","2580","-70","-2.64","7477135","20531393380"
"093320","케이아이엔엑스","63900","68300","4400","6.89","1542662","109175944300"
"093640","케이알엠","8410","8030","-380","-4.52","6215235","51417787290"
"073010","케이에스피","2620","3150","530","20.23","21420503","65383250445"
"105330","케이엔더블유","11550","10600","-950","-8.23","1064769","11839053980"
"053080","케이엔솔","11920","24950","13030","109.31","21209122","392342091100"
"272110","케이엔제이","23600","21150","-2450","-10.38","3023499","68899495610"
"039420","케이엘넷","2665","2485","-180","-6.75","1778307","4504316090"
"083550","케이엠","5360","5300","-60","-1.12","772885","4045395460"
"032500","케이엠더블유","13680","11860","-1820","-13.30","4306027","52999566670"
"225430","케이엠제약","1200","1121","-79","-6.58","2061395","2297161586"
"102370","케이옥션","4550","4380","-170","-3.74","1544704","6639788845"
"381970","케이카","13930","12420","-1510","-10.84","5413117","70254760600"
"145270","케이탑리츠","1001","1003","2","0.20","3653784","3684949320"
"036030","케이티알파","6150","5810","-340","-5.53","2569239","15338096680"
"064820","케이프","4680","4635","-45","-0.96","3265407","16085561210"
"256940","케이피에스","10280","9090","-1190","-11.58","4915760","52204804970"
"024880","케이피에프","5400","5150","-250","-4.63","3713798","19765942460"
"042040","케이피엠테크","448","409","-39","-8.71","32272664","13533707366"
"054410","케이피티유","6620","5680","-940","-14.20","1128764","6647275170"
"258610","케일럼","3820","3140","-680","-17.80","1711745","5705506805"
"274090","켄코아에어로스페이스","14650","13280","-1370","-9.35","2765967","37759259640"
"402420","켈스","10070","11490","1420","14.10","1027","11369130"
"089010","켐트로닉스","24450","22150","-2300","-9.41","4744146","116771624800"
"220260","켐트로스","8710","7430","-1280","-14.70","5936021","47851754110"
"176590","코나솔","7820","9260","1440","18.41","215349","1767655140"
"052400","코나아이","16620","16170","-450","-2.71","880166","13976273460"
"402030","코난테크놀로지","66500","85700","19200","28.87","8365911","680605333600"
"391710","코닉오토메이션","3480","3135","-345","-9.91","7130687","24838549630"
"046070","코다코","1099","821","-278","-25.30","5997729","5363122277"
"047770","코데즈컴바인","2340","1973","-367","-15.68","13895629","30200259815"
"078940","코드네이처","4245","3310","-935","-22.03","52856873","181144618630"
"080530","코디","1459","1380","-79","-5.41","3402896","5070132081"
"417310","코람코더원리츠","4755","4480","-275","-5.78","1014388","4759530920"
"357120","코람코에너지리츠","5640","5450","-190","-3.37","871294","4828779070"
"104540","코렌텍","12290","12600","310","2.52","1551162","19384773080"
"027050","코리아나","2805","2640","-165","-5.88","3205831","8390629155"
"007815","코리아써우","6280","6440","160","2.55","2590677","19933748790"
"007810","코리아써키트","16800","16860","60","0.36","21036248","409148271410"
"00781K","코리아써키트2우B","7510","7540","30","0.40","149704","1211793230"
"190650","코리아에셋투자증권","6870","6130","-740","-10.77","280119","1784882880"
"123410","코리아에프티","3990","3410","-580","-14.54","13877112","50629940070"
"003690","코리안리","6710","7030","320","4.77","4095692","28058678880"
"036690","코맥스","3360","3650","290","8.63","15538720","58776233675"
"049430","코메론","9330","8990","-340","-3.64","444808","3993243960"
"183300","코미코","59800","56400","-3400","-5.69","1989273","118247642000"
"041960","코미팜","6500","6280","-220","-3.38","3899657","24180842700"
"089890","코세스","13440","10900","-2540","-18.90","11093952","140723155590"
"009730","코센","4830","4975","145","3.00","11074610","56749565775"
"189350","코셋","2200","1811","-389","-17.68","3864","6552347"
"082660","코스나인","812","1636","824","101.48","296599472","453026308366"
"192820","코스맥스","89600","104000","14400","16.07","2473530","243729764307"
"044820","코스맥스비티아이","9280","9590","310","3.34","178898","1665572150"
"222040","코스맥스엔비티","6130","5300","-830","-13.54","2102418","11405270810"
"241710","코스메카코리아","25950","28600","2650","10.21","9026759","249512687850"
"005070","코스모신소재","198300","159900","-38400","-19.36","16120517","3145703468900"
"005420","코스모화학","55900","47950","-7950","-14.22","47958501","2810615926850"
"069110","코스온","2630","2630","0","0.00","0","0"
"355150","코스텍시스","3250","3470","220","6.77","58749520","200154366170"
"169670","코스텍시스템","7400","11420","4020","54.32","175219","1675703750"
"071950","코아스","752","706","-46","-6.12","3126554","2224039114"
"166480","코아스템켐온","7670","7210","-460","-6.00","1353163","9583966910"
"045970","코아시아","10000","9210","-790","-7.90","28332031","297280833500"
"196450","코아시아씨엠","1622","1705","83","5.12","3003774","4975120864"
"029960","코엔텍","7130","7560","430","6.03","5411735","39372228140"
"002020","코오롱","18990","18210","-780","-4.11","592099","10706009730"
"003070","코오롱글로벌","13840","12040","-1800","-13.01","1513254","19795913250"
"003075","코오롱글로벌우","20400","17820","-2580","-12.65","272041","5884914800"
"450140","코오롱모빌리티그룹","4050","3770","-280","-6.91","11070373","43905433270"
"45014K","코오롱모빌리티그룹우","8230","7420","-810","-9.84","117885","918830960"
"102940","코오롱생명과학","29300","27650","-1650","-5.63","288384","7968686350"
"002025","코오롱우","14540","13730","-810","-5.57","50043","685917610"
"120110","코오롱인더","51700","53900","2200","4.26","10514119","544623434150"
"120115","코오롱인더우","26050","26900","850","3.26","179524","4718373150"
"950160","코오롱티슈진","9430","9370","-60","-0.64","1747404","15565738840"
"138490","코오롱플라스틱","9390","8370","-1020","-10.86","2325275","20075467460"
"021240","코웨이","43300","40850","-2450","-5.66","4686756","199353373610"
"033290","코웰패션","4235","4840","605","14.29","13415003","61455311930"
"056360","코위버","6990","6280","-710","-10.16","1188668","7591428610"
"282880","코윈테크","36200","34650","-1550","-4.28","12877904","507827239650"
"121850","코이즈","2110","2135","25","1.18","41549382","97528084308"
"015710","코콤","5000","4800","-200","-4.00","5336015","25816366625"
"052330","코텍","8410","7830","-580","-6.90","939596","7557082670"
"322780","코퍼스코리아","2300","2565","265","11.52","16298319","40238515580"
"036420","콘텐트리중앙","15580","16640","1060","6.80","4810075","79766883400"
"200130","콜마비앤에이치","18210","17900","-310","-1.70","2381285","42012697040"
"031820","콤텍시스템","847","792","-55","-6.49","49671700","42244097463"
"294570","쿠콘","22850","24350","1500","6.56","1642166","38411714000"
"192400","쿠쿠홀딩스","15930","15560","-370","-2.32","428277","6619391970"
"284740","쿠쿠홈시스","23000","22350","-650","-2.83","480281","10585161500"
"317690","퀀타매트릭스","4400","4950","550","12.50","4286058","21980244495"
"456190","큐라켐","19000","17920","-1080","-5.68","200","3637000"
"365270","큐라클","10060","13600","3540","35.19","16219728","220100818910"
"348080","큐라티스","3150","3370","220","6.98","99681250","346521169765"
"086460","큐러블","6970","6980","10","0.14","43","294120"
"060280","큐렉소","19330","18040","-1290","-6.67","69973016","1322107851080"
"040350","큐로컴","491","474","-17","-3.46","7007588","3327763856"
"051780","큐로홀딩스","394","391","-3","-0.76","7002597","2746276591"
"115180","큐리언트","8080","7570","-510","-6.31","1521183","11925373480"
"182360","큐브엔터","23150","22000","-1150","-4.97","6302105","137620724370"
"405100","큐알티","12710","11770","-940","-7.40","1326195","16755509420"
"066310","큐에스아이","11020","10240","-780","-7.08","3149922","32982691560"
"136660","큐엠씨","1289","1100","-189","-14.66","141055","139634766"
"016600","큐캐피탈","419","381","-38","-9.07","20535329","8198873413"
"264900","크라운제과","8900","8280","-620","-6.97","451803","3811034580"
"26490K","크라운제과우","10590","10360","-230","-2.17","68522","705039360"
"005740","크라운해태홀딩스","6060","5770","-290","-4.79","315608","1825057150"
"005745","크라운해태홀딩스우","10340","10130","-210","-2.03","23304","226826490"
"259960","크래프톤","178500","174400","-4100","-2.30","2297981","407332578100"
"096240","크레버스","17830","16660","-1170","-6.56","1102698","18270595590"
"215570","크로넥스","2000","1491","-509","-25.45","90689","143152587"
"114120","크루셜텍","10850","10850","0","0.00","0","0"
"110790","크리스에프앤씨","17830","18730","900","5.05","555700","9676214360"
"900250","크리스탈신소재","3850","2780","-1070","-27.79","236820573","744619067045"
"045520","크린앤사이언스","7600","7090","-510","-6.71","535077","3767031350"
"036170","클라우드에어","1230","1031","-199","-16.18","11643002","12841744772"
"214150","클래시스","31800","32750","950","2.99","8502639","261658824075"
"352770","클리노믹스","5400","4845","-555","-10.28","17201028","86890944075"
"237880","클리오","19740","19040","-700","-3.55","2807026","54868287390"
"139670","키네마스터","6790","5320","-1470","-21.65","1450430","8311478070"
"020120","키다리스튜디오","6870","5670","-1200","-17.47","3085634","18867988680"
"413600","키움제6호스팩","2215","2145","-70","-3.16","124876","270482945"
"433530","키움제7호스팩","2140","2090","-50","-2.34","146761","314846615"
"446840","키움제8호스팩","2125","2080","-45","-2.12","578118","1210466650"
"039490","키움증권","86900","100000","13100","15.07","1974885","188897976000"
"054780","키이스트","6690","7320","630","9.42","8404641","67274420260"
"336040","타스컴","12490","11890","-600","-4.80","9849","108769430"
"219130","타이거일렉","28850","29200","350","1.21","1248764","39612943650"
"346010","타이드","5210","5590","380","7.29","1998","7769320"
"318660","타임기술","1528","1436","-92","-6.02","10645","15747802"
"434190","탈로스","8450","8870","420","4.97","69024","631994790"
"360070","탑머티리얼","64300","68100","3800","5.91","5553131","444368388500"
"180060","탑선","8830","7530","-1300","-14.72","49303","391683090"
"065130","탑엔지니어링","6060","6350","290","4.79","3471938","22740882680"
"134580","탑코미디어","4785","4730","-55","-1.15","1837268","8637551690"
"014580","태경비케이","8730","7290","-1440","-16.49","18906841","154643996350"
"015890","태경산업","7880","6780","-1100","-13.96","6490616","46726725190"
"006890","태경케미컬","15120","13880","-1240","-8.20","6346282","94335492120"
"023160","태광","19540","21200","1660","8.50","7475778","155607527030"
"003240","태광산업","614000","608000","-6000","-0.98","20437","12312007000"
"011280","태림포장","2630","2435","-195","-7.41","1851594","4579456125"
"323280","태성","2355","2900","545","23.14","134220807","475923112885"
"053620","태양","8170","7720","-450","-5.51","109321","863372300"
"052960","태양3C","4195","4075","-120","-2.86","13556","55187060"
"004100","태양금속","1675","1828","153","9.13","8815243","15299375494"
"004105","태양금속우","2845","3090","245","8.61","400851","1104042740"
"116100","태양기계","1500","1488","-12","-0.80","8976","11917199"
"009410","태영건설","3870","3955","85","2.20","3291474","12348041185"
"009415","태영건설우","6310","6260","-50","-0.79","105722","632994745"
"044490","태웅","17050","16550","-500","-2.93","2596597","46392143240"
"124560","태웅로직스","3940","3845","-95","-2.41","4183573","15689577805"
"001420","태원물산","5020","4965","-55","-1.10","238836","1175281050"
"007980","태평양물산","1738","2080","342","19.68","44515408","87860983861"
"191420","테고사이언스","10410","9760","-650","-6.24","705470","6856803530"
"073640","테라사이언스","6100","4490","-1610","-26.39","290630774","1517934456965"
"066700","테라젠이텍스","4195","4505","310","7.39","13053790","57474814680"
"095610","테스","21450","20750","-700","-3.26","7233417","158314667660"
"055490","테이팩스","51100","40500","-10600","-20.74","902723","44732654850"
"308700","테크엔","258","162","-96","-37.21","29899","7640318"
"064520","테크엘","5320","4120","-1200","-22.56","1592153","7291982430"
"089030","테크윙","8160","7880","-280","-3.43","14772264","124776198060"
"258050","테크트랜스","919","889","-30","-3.26","42771","32675570"
"054450","텔레칩스","20000","18610","-1390","-6.95","29597886","643819751400"
"091440","텔레필드","2265","2360","95","4.19","21525077","57906120291"
"078000","텔코웨어","9110","9020","-90","-0.99","144434","1271289540"
"200230","텔콘RF제약","1109","929","-180","-16.23","6116925","5905284283"
"214420","토니모리","5900","4710","-1190","-20.17","5164663","24827303145"
"393210","토마토시스템","4900","3640","-1260","-25.71","8960886","39950060140"
"215480","토박스코리아","4355","4000","-355","-8.15","626054","2549206115"
"051360","토비스","14560","15400","840","5.77","5249792","75039852680"
"045340","토탈소프트","4840","4290","-550","-11.36","1068803","4788911895"
"108230","톱텍","8190","7200","-990","-12.09","3509929","26161965600"
"079970","투비소프트","847","941","94","11.10","32897706","30539459740"
"199800","툴젠","35350","40450","5100","14.43","862157","34095720350"
"417790","트루엔","12360","11230","-1130","-9.14","6570651","74221239480"
"105550","트루윈","2180","2275","95","4.36","8404320","17921836938"
"290090","트윔","14870","13300","-1570","-10.56","294362","4091637660"
"026150","특수건설","7860","7850","-10","-0.13","4002270","32532178000"
"322180","티라유텍","14830","19690","4860","32.77","2916075","49623537370"
"117730","티로보틱스","20600","28100","7500","36.41","42630462","1067046430620"
"033830","티비씨","1001","924","-77","-7.69","3694161","3519063973"
"057680","티사이언티픽","3500","3325","-175","-5.00","6687188","23326679080"
"204610","티쓰리","1628","1433","-195","-11.98","16653213","24396253466"
"064760","티씨케이","106800","97100","-9700","-9.08","1006690","99818972100"
"246710","티앤알바이오팹","11820","12320","500","4.23","2066072","24386269140"
"340570","티앤엘","51000","51100","100","0.20","1604647","78984607950"
"043220","티에스넥스젠","680","668","-12","-1.76","9543119","6052619097"
"277880","티에스아이","13480","12360","-1120","-8.31","16108975","239210951700"
"131290","티에스이","51700","45550","-6150","-11.90","3888335","198927116950"
"019180","티에이치엔","3815","3320","-495","-12.98","3867965","12995751970"
"425420","티에프이","19870","24400","4530","22.80","16557163","378927256380"
"356860","티엘비","27300","23150","-4150","-15.20","9589214","253763012050"
"062860","티엘아이","5800","5800","0","0.00","0","0"
"413300","티엘엔지니어링","3870","3875","5","0.13","764","2630635"
"363280","티와이홀딩스","8030","6970","-1060","-13.20","2649727","18733018060"
"36328K","티와이홀딩스우","9570","7880","-1690","-17.66","132889","1084123860"
"321550","티움바이오","8600","8200","-400","-4.65","1633998","12156054540"
"091810","티웨이항공","3170","2590","-580","-18.30","36705396","103682374940"
"004870","티웨이홀딩스","619","542","-77","-12.44","5473523","3069890276"
"425040","티이엠씨","50100","42650","-7450","-14.87","3804054","187536941050"
"104480","티케이케미칼","2215","2170","-45","-2.03","48577031","120953264790"
"081150","티플랙스","3875","3915","40","1.03","43410739","180291304110"
"130740","티피씨글로벌","2825","2640","-185","-6.55","1141496","2973802010"
"217880","틸론","15380","5050","-10330","-67.17","1424401","12356083685"
"084730","팅크웨어","11610","15940","4330","37.30","3196370","45215845870"
"046210","파나진","5620","4730","-890","-15.84","12715313","65859992120"
"058530","파나케이아","1620","1620","0","0.00","0","0"
"034230","파라다이스","14080","14450","370","2.63","17907825","253708766260"
"033540","파라텍","805","725","-80","-9.94","4747048","3628160339"
"043200","파루","823","762","-61","-7.41","3460472","2736648010"
"214450","파마리서치","129200","140500","11300","8.75","3351760","441138059500"
"217950","파마리서치바이오","28450","23300","-5150","-18.10","18214","435720550"
"208340","파멥신","3135","2275","-860","-27.43","7329639","20379241965"
"005690","파미셀","7250","7140","-110","-1.52","7241659","49829048480"
"177830","파버나인","4335","4235","-100","-2.31","5250462","23044946630"
"037070","파세코","13250","10490","-2760","-20.83","2208684","25664495050"
"150900","파수","8310","7320","-990","-11.91","1017439","7734121640"
"037030","파워넷","3570","3275","-295","-8.26","6194722","21256656640"
"047310","파워로직스","6170","8430","2260","36.63","208696306","2018778304080"
"266870","파워풀엑스","900","950","50","5.56","39080","37892759"
"368770","파이버프로","4530","4420","-110","-2.43","16430135","70960923445"
"170790","파이오링크","16270","15280","-990","-6.08","1188387","19332052650"
"049120","파인디앤씨","1411","1296","-115","-8.15","796883","1079985097"
"038950","파인디지털","5140","4840","-300","-5.84","383344","1870507610"
"441270","파인엠텍","9200","8130","-1070","-11.63","7400993","61338869360"
"106240","파인테크닉스","2470","2115","-355","-14.37","5419009","12024694904"
"131760","파인텍","1089","1108","19","1.74","3853308","4066511668"
"065690","파커스","1820","1625","-195","-10.71","926545","1535690552"
"140860","파크시스템스","186500","197400","10900","5.84","1078745","203973783400"
"091700","파트론","8760","7890","-870","-9.93","9070838","75923259120"
"202960","판도라티비","884","847","-37","-4.19","70557","51725370"
"032800","판타지오","388","333","-55","-14.18","32340178","11528250478"
"318010","팜스빌","9440","9110","-330","-3.50","437683","4170195850"
"036580","팜스코","4140","3830","-310","-7.49","1951299","7527562980"
"027710","팜스토리","2145","1910","-235","-10.96","73543935","154816729520"
"004720","팜젠사이언스","5640","6190","550","9.75","10736922","66938837240"
"225590","패션플랫폼","1501","1391","-110","-7.33","2516347","3593675514"
"054300","팬스타엔터프라이즈","722","705","-17","-2.35","5165042","3659364771"
"068050","팬엔터테인먼트","4750","4425","-325","-6.84","8090973","34260910370"
"028670","팬오션","4960","4775","-185","-3.73","52830004","257098239270"
"222110","팬젠","5090","5480","390","7.66","860566","4389134880"
"271830","팸텍","5400","4300","-1100","-20.37","9109739","44069943695"
"010820","퍼스텍","4010","3620","-390","-9.73","22554180","90465345425"
"016800","퍼시스","30000","30000","0","0.00","19259","578200900"
"263750","펄어비스","50000","56200","6200","12.40","7891358","434427432700"
"251970","펌텍코리아","22500","27300","4800","21.33","3654811","90425779850"
"001020","페이퍼코리아","1108","870","-238","-21.48","10341696","9124652928"
"327610","펨토바이오메드","9200","8000","-1200","-13.04","35858","292474460"
"168360","펨트론","16910","14990","-1920","-11.35","8940690","146903324800"
"087010","펩트론","14170","33550","19380","136.77","59124893","1453722836010"
"090080","평화산업","1649","1440","-209","-12.67","12464865","18984160445"
"010770","평화홀딩스","3980","3300","-680","-17.09","1288898","4524519575"
"119500","포메탈","3535","3305","-230","-6.51","1599681","5368308935"
"389140","포바이포","11020","10520","-500","-4.54","2922389","33597320650"
"022100","포스코DX","16600","32000","15400","92.77","438992739","12095236562580"
"058430","포스코스틸리온","52600","63700","11100","21.10","23959351","1810638404800"
"009520","포스코엠텍","23800","29950","6150","25.84","197218952","6812694288050"
"047050","포스코인터내셔널","43900","89000","45100","102.73","191961475","14245422420600"
"003670","포스코퓨처엠","373500","456000","82500","22.09","39738573","19759010968500"
"189690","포시에스","3500","2380","-1120","-32.00","9957890","26812357350"
"318020","포인트모바일","18100","18100","0","0.00","0","0"
"256630","포인트엔지니어링","1980","1958","-22","-1.11","1446940","2748200526"
"331380","포커스에이치엔에스","2850","2520","-330","-11.58","24621610","64365308100"
"234100","폴라리스세원","2360","1951","-409","-17.33","9268661","19557169864"
"041020","폴라리스오피스","2855","6330","3475","121.72","440311447","2214195782100"
"114630","폴라리스우노","791","727","-64","-8.09","29786712","23684417121"
"290720","푸드나무","9720","8040","-1680","-17.28","2852197","26734440850"
"005670","푸드웰","5500","4915","-585","-10.64","461176","2371717980"
"094940","푸른기술","7890","7550","-340","-4.31","5718772","49041195060"
"007330","푸른저축은행","9230","8640","-590","-6.39","481422","4219673090"
"017810","풀무원","10450","10270","-180","-1.72","1065797","10779361010"
"093380","풍강","4270","4045","-225","-5.27","676095","2731866405"
"023900","풍국주정","16360","13250","-3110","-19.01","5288098","81002506130"
"103140","풍산","40150","36000","-4150","-10.34","4631186","181688949250"
"005810","풍산홀딩스","35400","34900","-500","-1.41","1147633","44120576550"
"371950","풍원정밀","10000","9000","-1000","-10.00","1238130","11380192460"
"370090","퓨런티어","27150","28200","1050","3.87","14976116","498976949850"
"341170","퓨쳐메디신","7290","7800","510","7.00","234624","1831390750"
"220100","퓨쳐켐","8100","13440","5340","65.93","12383037","128364903240"
"035200","프럼파스트","3610","3360","-250","-6.93","1218438","4310327530"
"334970","프레스티지바이오로직스","4440","5240","800","18.02","23675500","117287994060"
"950210","프레스티지바이오파마","9050","13100","4050","44.75","11704802","144444509290"
"321260","프로이천","3140","3980","840","26.75","123823768","456527849635"
"303360","프로테옴텍","3780","3525","-255","-6.75","4238135","15925822780"
"053610","프로텍","54100","44700","-9400","-17.38","14040010","786396348850"
"377220","프롬바이오","7500","7020","-480","-6.40","705088","5000548250"
"335810","프리시젼바이오","6070","6600","530","8.73","1125364","7362885980"
"053160","프리엠스","9560","10570","1010","10.56","1330419","13810923180"
"405000","플라즈맵","5980","5880","-100","-1.67","3493943","20283047910"
"041590","플래스크","1048","1084","36","3.44","11121534","11747951192"
"367000","플래티어","10360","10330","-30","-0.29","634402","6356287560"
"075130","플랜티넷","2530","2365","-165","-6.52","1375376","3364246265"
"222670","플럼라인생명과학","7000","7300","300","4.29","18628","135732750"
"009810","플레이그램","754","619","-135","-17.90","11791237","8215290584"
"237820","플레이디","5120","5660","540","10.55","24935669","177908959760"
"023770","플레이위드","5510","5370","-140","-2.54","988270","5144710625"
"300080","플리토","27150","36000","8850","32.60","3968285","140921926200"
"150440","피노텍","994","994","0","0.00","0","0"
"032580","피델릭스","1663","1420","-243","-14.61","28961554","47988344291"
"051380","피씨디렉트","8060","7300","-760","-9.43","1504233","11377123620"
"241820","피씨엘","5929","7750","1821","30.71","3586254","26880908680"
"237750","피앤씨테크","6620","6010","-610","-9.21","1771120","11268725300"
"319660","피에스케이","21000","20900","-100","-0.48","11040080","244496282350"
"031980","피에스케이홀딩스","20100","26000","5900","29.35","17629084","468439581790"
"002230","피에스텍","4140","4330","190","4.59","409992","1698548860"
"057880","피에이치씨","1740","1740","0","0.00","0","0"
"043370","피에이치에이","11350","9330","-2020","-17.80","2372809","25235561110"
"242350","피엔아이컴퍼니","3695","1091","-2604","-70.47","763144","1331491092"
"239890","피엔에이치테크","22600","19530","-3070","-13.58","2166440","45016547420"
"347740","피엔케이피부임상연구센타","2955","3130","175","5.92","15998767","51034850600"
"137400","피엔티","55900","72000","16100","28.80","24611924","1772986616800"
"147760","피엠티","5280","5250","-30","-0.57","3042860","17257009635"
"128660","피제이메탈","4955","4265","-690","-13.93","7687999","35553618445"
"006140","피제이전자","6560","5990","-570","-8.69","1718677","10423724260"
"376180","피코그램","8790","6550","-2240","-25.48","7379019","56237313940"
"304840","피플바이오","10510","9790","-720","-6.85","4017975","37385136110"
"062970","피피아이","2745","2625","-120","-4.37","3667819","9685870540"
"087600","픽셀플러스","7470","6390","-1080","-14.46","374880","2540827320"
"291810","핀텔","6540","6320","-220","-3.36","4732063","32830101290"
"161580","필옵틱스","14170","9440","-4730","-33.38","71343104","1125507686740"
"347770","핌스","14500","18210","3710","25.59","3047914","54457750970"
"163730","핑거","10560","10340","-220","-2.08","779959","7861575730"
"417180","핑거스토리","4320","4020","-300","-6.94","3531488","15330193555"
"446750","하나26호스팩","2135","2110","-25","-1.17","411893","878854980"
"448370","하나27호스팩","2150","2150","0","0.00","0","0"
"454640","하나29호스팩","2140","2100","-40","-1.87","594424","1266093170"
"400560","하나금융20호스팩","3015","2770","-245","-8.13","2967348","8625081170"
"406760","하나금융21호스팩","2250","2135","-115","-5.11","324882","708448770"
"418170","하나금융22호스팩","2120","2150","30","1.42","765399","1618306900"
"427950","하나금융23호스팩","2360","2360","0","0.00","0","0"
"430230","하나금융24호스팩","2205","2135","-70","-3.17","408018","883867995"
"435620","하나금융25호스팩","9760","9760","0","0.00","0","0"
"086790","하나금융지주","38000","37900","-100","-0.26","26674247","1039653060725"
"299030","하나기술","98600","111000","12400","12.58","13130843","1578950908600"
"067310","하나마이크론","20500","19000","-1500","-7.32","54204194","1140941605220"
"372290","하나머스트7호스팩","2405","2405","0","0.00","0","0"
"166090","하나머티리얼즈","49000","45100","-3900","-7.96","4232283","201606386100"
"293480","하나제약","13680","14400","720","5.26","680242","9440321790"
"039130","하나투어","50400","48000","-2400","-4.76","1856760","90550374150"
"136480","하림","3040","2885","-155","-5.10","14841658","42624515520"
"003380","하림지주","7480","7410","-70","-0.94","12578144","92150534790"
"101670","하이드로리튬","31400","25800","-5600","-17.83","24633090","713225098900"
"365590","하이딥","1960","1587","-373","-19.03","33797087","61886886695"
"149980","하이로닉","8680","10310","1630","18.78","16695668","156244720810"
"013030","하이록코리아","28150","29500","1350","4.80","3698658","105335071400"
"352820","하이브","279500","259500","-20000","-7.16","9251455","2446285174330"
"126700","하이비젼시스템","19670","20550","880","4.47","6498778","134053693760"
"106080","하이소닉","9450","8390","-1060","-11.22","2121089","20541201620"
"071090","하이스틸","4200","3685","-515","-12.26","4716574","18793661410"
"377400","하이제6호스팩","2270","2270","0","0.00","0","0"
"400840","하이제7호스팩","2200","2090","-110","-5.00","380817","806762585"
"450050","하이제8호스팩","2115","2105","-10","-0.47","475417","1005474210"
"221840","하이즈항공","3175","2990","-185","-5.83","918350","2669295845"
"106190","하이텍팜","13450","12970","-480","-3.57","189106","2414709020"
"019490","하이트론","2470","2470","0","0.00","0","0"
"000080","하이트진로","20800","20300","-500","-2.40","5521131","112335342380"
"000087","하이트진로2우B","16240","15630","-610","-3.76","64137","1009027380"
"000140","하이트진로홀딩스","9170","9030","-140","-1.53","228443","2060824920"
"000145","하이트진로홀딩스우","12370","11780","-590","-4.77","7688","90980970"
"373200","하인크코리아","5520","4695","-825","-14.95","5195410","26145329855"
"066130","하츠","5440","5020","-420","-7.72","538781","2733834880"
"152550","한국ANKOR유전","655","532","-123","-18.78","237106336","145868150206"
"004590","한국가구","4590","4230","-360","-7.84","1317655","5807996125"
"036460","한국가스공사","24450","25800","1350","5.52","5522246","138146719500"
"039340","한국경제TV","6000","5970","-30","-0.50","761402","4536019010"
"005430","한국공항","38600","36200","-2400","-6.22","106069","3940832200"
"071050","한국금융지주","48950","52000","3050","6.23","3700895","184958097150"
"071055","한국금융지주우","39450","40300","850","2.15","271961","10474896350"
"034950","한국기업평가","74000","76000","2000","2.70","63336","4679218300"
"010040","한국내화","3725","3275","-450","-12.08","5836339","19916325630"
"025540","한국단자","62700","56500","-6200","-9.89","381001","22384619800"
"222980","한국맥널티","5390","4985","-405","-7.51","1487429","7640184040"
"010100","한국무브넥스","4185","4710","525","12.54","47184781","243058448895"
"331660","한국미라클피플사","15500","15500","0","0.00","0","0"
"256840","한국비엔씨","3405","3840","435","12.78","22527296","79340750445"
"004090","한국석유","10080","9830","-250","-2.48","941665","9260838000"
"025550","한국선재","4025","3985","-40","-0.99","5528108","21847760840"
"002200","한국수출포장","2940","2980","40","1.36","1705569","4948550435"
"002960","한국쉘석유","224000","221500","-2500","-1.12","30638","6715859500"
"017890","한국알콜","11010","13470","2460","22.34","4920222","61836278890"
"000240","한국앤컴퍼니","12030","11310","-720","-5.99","2263863","26004216310"
"080720","한국유니온제약","5190","5200","10","0.19","751619","3754195725"
"123890","한국자산신탁","3065","3165","100","3.26","2734009","8222934730"
"015760","한국전력","20050","19370","-680","-3.39","27701424","546039367450"
"063570","한국전자금융","6500","6160","-340","-5.23","5646660","34726102540"
"041460","한국전자인증","4620","4330","-290","-6.28","2863413","12892848325"
"006200","한국전자홀딩스","1256","1169","-87","-6.93","6354546","7498532786"
"101680","한국정밀기계","4005","3475","-530","-13.23","700913","2631871325"
"039740","한국정보공학","3365","3025","-340","-10.10","909891","2921284455"
"053300","한국정보인증","4735","4695","-40","-0.84","17201266","96740500275"
"025770","한국정보통신","9150","8530","-620","-6.78","1717486","14752204930"
"409570","한국제10호스팩","3295","3305","10","0.30","9751467","33599021740"
"436610","한국제11호스팩","2790","2790","0","0.00","0","0"
"023350","한국종합기술","6530","6190","-340","-5.21","1508407","9659389650"
"025890","한국주강","3090","2650","-440","-14.24","1053439","3048403085"
"000970","한국주철관","7380","6790","-590","-7.99","830523","5794292500"
"104700","한국철강","6880","6050","-830","-12.06","3559328","22272262320"
"017960","한국카본","11850","14560","2710","22.87","24916085","344056738130"
"023760","한국캐피탈","649","594","-55","-8.47","5601689","3423273860"
"054040","한국컴퓨터","4185","4030","-155","-3.70","689394","2769321045"
"161890","한국콜마","45800","51200","5400","11.79","3788917","181601216000"
"024720","한국콜마홀딩스","13900","13930","30","0.22","1028098","13786287880"
"021650","한국큐빅","3130","2850","-280","-8.95","674667","1976368050"
"161390","한국타이어앤테크놀로지","36750","39650","2900","7.89","6687593","254697300950"
"053590","한국테크놀로지","334","334","0","0.00","0","0"
"034830","한국토지신탁","1330","1258","-72","-5.41","16859760","21552251886"
"007280","한국특강","2005","1796","-209","-10.42","1381206","2581653130"
"032300","한국파마","17660","17510","-150","-0.85","1202290","22420674390"
"168490","한국패러랠","2195","1993","-202","-9.20","668429","1398789420"
"037230","한국팩키지","2465","2145","-320","-12.98","801996","1830926220"
"047810","한국항공우주","53800","48200","-5600","-10.41","15967327","817474211532"
"123690","한국화장품","6120","5750","-370","-6.05","603799","3489322780"
"003350","한국화장품제조","25650","23600","-2050","-7.99","700006","17058754550"
"030520","한글과컴퓨터","12150","13870","1720","14.16","23847638","346638742730"
"052600","한네트","5240","4715","-525","-10.02","1390617","6782230975"
"011500","한농화성","19840","15960","-3880","-19.56","11510560","224140967650"
"002390","한독","14010","13550","-460","-3.28","423710","5649348890"
"256150","한독크린텍","8670","8430","-240","-2.77","586346","4854654050"
"092460","한라IMS","7080","6480","-600","-8.47","1930414","13467914060"
"053690","한미글로벌","28300","25450","-2850","-10.07","4422920","122555932350"
"042700","한미반도체","29250","46750","17500","59.83","134231608","5955149147750"
"008930","한미사이언스","31350","41150","9800","31.26","6487411","231302958500"
"128940","한미약품","295500","325500","30000","10.15","1831998","529363836000"
"047080","한빛소프트","2640","2225","-415","-15.72","1706695","3970837955"
"009240","한샘","42500","54500","12000","28.24","1199253","57326676300"
"020000","한섬","22150","19340","-2810","-12.69","2191781","45656961080"
"003680","한성기업","5560","5130","-430","-7.73","543005","2814090205"
"105630","한세실업","19750","19200","-550","-2.78","3863907","72928551330"
"069640","한세엠케이","2640","2380","-260","-9.85","405827","971725145"
"016450","한세예스24홀딩스","4860","4410","-450","-9.26","432122","1962182500"
"010420","한솔PNS","1648","1493","-155","-9.41","1803976","2860645455"
"009180","한솔로지스틱스","2590","2460","-130","-5.02","2558810","6397370515"
"114810","한솔아이원스","9430","8920","-510","-5.41","2552621","23509501040"
"070590","한솔인티큐브","1785","1907","122","6.83","12103209","27332613574"
"213500","한솔제지","10820","10620","-200","-1.85","1979221","20793416530"
"014680","한솔케미칼","217000","188800","-28200","-13.00","1865484","379268154548"
"004710","한솔테크닉스","7740","6680","-1060","-13.70","3683509","26584091320"
"004150","한솔홀딩스","3115","2855","-260","-8.35","1521043","4454338970"
"025750","한솔홈데코","1058","976","-82","-7.75","6326591","6320470085"
"226440","한송네오텍","1530","1530","0","0.00","0","0"
"042520","한스바이오메드","24000","24050","50","0.21","10766290","271157598350"
"004960","한신공영","8060","7400","-660","-8.19","1308942","10391183470"
"011700","한신기계","5010","4655","-355","-7.09","23586679","135430376350"
"078350","한양디지텍","15240","12890","-2350","-15.42","3779018","54891456770"
"045100","한양이엔지","16100","17040","940","5.84","36766821","704566099880"
"001750","한양증권","8740","8930","190","2.17","237964","2081298260"
"001755","한양증권우","12430","11880","-550","-4.42","9171","108117140"
"018880","한온시스템","9240","8520","-720","-7.79","18066162","159269979838"
"009420","한올바이오파마","20150","24150","4000","19.85","11061427","250708132090"
"014130","한익스프레스","5650","5640","-10","-0.18","551456","2963883210"
"024740","한일단조","2720","2365","-355","-13.05","6166202","15646315540"
"005860","한일사료","6010","5820","-190","-3.16","84188248","527131884520"
"300720","한일시멘트","11900","12270","370","3.11","1408558","16651446520"
"123840","한일진공","429","372","-57","-13.29","6734611","2636456905"
"002220","한일철강","3250","3115","-135","-4.15","1967977","6231713330"
"006390","한일현대시멘트","17100","17150","50","0.29","454079","7698187660"
"003300","한일홀딩스","11840","11130","-710","-6.00","149763","1706843920"
"007770","한일화학","25000","21600","-3400","-13.60","9997254","267911424500"
"051600","한전KPS","31700","33800","2100","6.62","3683656","122990404600"
"052690","한전기술","67800","71700","3900","5.75","6468977","484234323300"
"130660","한전산업","7090","8270","1180","16.64","47340249","424077416880"
"198940","한주라이트메탈","5900","4195","-1705","-28.90","5461569","27325627195"
"107640","한중엔시에스","12440","21550","9110","73.23","36820","647250710"
"002320","한진","19340","21900","2560","13.24","1459514","29153789530"
"003480","한진중공업홀딩스","3650","3375","-275","-7.53","647971","2255135675"
"180640","한진칼","46400","47150","750","1.62","1504023","66250505350"
"18064K","한진칼우","26150","25750","-400","-1.53","57984","1451207400"
"005110","한창","630","409","-221","-35.08","65500196","29498920197"
"079170","한창산업","13470","10620","-2850","-21.16","1796199","21021331300"
"009460","한창제지","1332","1025","-307","-23.05","3037177","3396547449"
"372910","한컴라이프케어","5790","5220","-570","-9.84","5927370","32045995625"
"054920","한컴위드","3805","3375","-430","-11.30","8480243","31257538865"
"002680","한탑","1623","1678","55","3.39","65612647","127629365030"
"000880","한화","28750","29650","900","3.13","8763066","272960497200"
"00088K","한화3우B","14380","14710","330","2.29","843600","12660187750"
"452260","한화갤러리아","1403","1247","-156","-11.12","33520734","44202376356"
"45226K","한화갤러리아우","6010","4335","-1675","-27.87","454702","2168318790"
"451800","한화리츠","5290","5220","-70","-1.32","993353","5209277040"
"088350","한화생명","2440","2485","45","1.84","33419716","80939429260"
"000370","한화손해보험","3925","4100","175","4.46","5671080","22366147610"
"009830","한화솔루션","41150","37500","-3650","-8.87","30216658","1233111334850"
"009835","한화솔루션우","30200","28200","-2000","-6.62","288716","8371641500"
"272210","한화시스템","14640","14560","-80","-0.55","61479352","982554084670"
"012450","한화에어로스페이스","131600","118000","-13600","-10.33","17694979","2291115303101"
"042660","한화오션","38800","45650","6850","17.65","36579078","1660613412250"
"000885","한화우","31900","31100","-800","-2.51","13052","418792700"
"003530","한화투자증권","2590","2565","-25","-0.97","14371649","37372254380"
"003535","한화투자증권우","4850","4180","-670","-13.81","227285","997017120"
"386580","한화플러스제2호스팩","2215","2185","-30","-1.35","220083","482812310"
"430460","한화플러스제3호스팩","2135","2095","-40","-1.87","388337","822198670"
"195870","해성디에스","63000","66300","3300","5.24","7537422","527970748200"
"034810","해성산업","9030","8530","-500","-5.54","838008","7260010910"
"03481K","해성산업1우","10150","9590","-560","-5.52","92408","909510200"
"076610","해성옵틱스","432","443","11","2.55","9902367","4121155437"
"059270","해성티피씨","6950","6880","-70","-1.01","2461032","16552424570"
"101530","해태제과식품","5940","5460","-480","-8.08","397893","2255378280"
"220180","핸디소프트","3815","3265","-550","-14.42","6484451","23859359630"
"143210","핸즈코퍼레이션","3350","3180","-170","-5.07","240929","751344985"
"900270","헝셩그룹","306","248","-58","-18.95","31341589","8458384010"
"214180","헥토이노베이션","13050","13580","530","4.06","960871","12760445880"
"234340","헥토파이낸셜","17180","16670","-510","-2.97","394627","6471299600"
"084990","헬릭스미스","6080","6040","-40","-0.66","4864177","28507755840"
"000720","현대건설","35450","35650","200","0.56","20256766","752822775600"
"000725","현대건설우","58100","53700","-4400","-7.57","147057","8684459200"
"170030","현대공업","9190","7540","-1650","-17.95","7256137","62269124810"
"453340","현대그린푸드","12250","11930","-320","-2.61","3737745","43651578470"
"086280","현대글로비스","198400","168600","-29800","-15.02","2673513","487744157672"
"064350","현대로템","37900","29750","-8150","-21.50","67316728","2257178861750"
"079430","현대리바트","8310","8090","-220","-2.65","1002591","7567798550"
"012330","현대모비스","233000","234000","1000","0.43","5222754","1229913986324"
"319400","현대무벡스","4345","3730","-615","-14.15","36914808","147964953890"
"010620","현대미포조선","86500","93000","6500","7.51","6953302","631402422300"
"048410","현대바이오","23750","27850","4100","17.26","21393325","533335604600"
"052260","현대바이오랜드","11730","10250","-1480","-12.62","968928","10423896680"
"069960","현대백화점","51400","56500","5100","9.92","3210585","178351006600"
"004560","현대비앤지스틸","15310","13530","-1780","-11.63","3068617","43946213010"
"004310","현대약품","3860","4190","330","8.55","8820021","36881962425"
"041440","현대에버다임","7950","7000","-950","-11.95","7496321","57624726910"
"039010","현대에이치티","7080","7000","-80","-1.13","1413210","9953069610"
"017800","현대엘리베이","39050","43450","4400","11.27","4132171","172780023700"
"307950","현대오토에버","151300","163200","11900","7.87","4046291","617089832600"
"011210","현대위아","67800","58900","-8900","-13.13","5247702","338383411700"
"090850","현대이지웰","7520","6500","-1020","-13.56","2369553","16165967860"
"004020","현대제철","33400","34950","1550","4.64","13158783","455570444300"
"005440","현대지에프홀딩스","3580","3385","-195","-5.45","3444562","11545317725"
"005380","현대차","206500","189400","-17100","-8.28","15225821","3022673963923"
"005387","현대차2우B","112300","103500","-8800","-7.84","1825432","195934324183"
"005389","현대차3우B","108200","101300","-6900","-6.38","252455","26196656200"
"005385","현대차우","110300","102600","-7700","-6.98","957916","101617469300"
"001500","현대차증권","8560","8320","-240","-2.80","775033","6422667760"
"011760","현대코퍼레이션","21900","23150","1250","5.71","5481220","129944836600"
"227840","현대코퍼레이션홀딩스","11700","11380","-320","-2.74","683093","7898027290"
"126560","현대퓨처넷","2830","2890","60","2.12","4960091","13823828425"
"001450","현대해상","29950","30550","600","2.00","8652320","254093070728"
"057050","현대홈쇼핑","44900","42400","-2500","-5.57","453965","19480404350"
"092300","현우산업","5540","4790","-750","-13.54","9110219","49783526815"
"138360","협진","1340","1040","-300","-22.39","14274943","17681229529"
"011080","형지I&C","1143","996","-147","-12.86","2659620","2765188021"
"093240","형지엘리트","1428","1260","-168","-11.76","2626355","3455019469"
"003010","혜인","6020","5730","-290","-4.82","7330087","42583447390"
"111110","호전실업","8700","8150","-550","-6.32","1515452","12690629750"
"008770","호텔신라","73400","74000","600","0.82","7822935","573303990100"
"008775","호텔신라우","50700","47700","-3000","-5.92","57198","2770919800"
"060560","홈센타홀딩스","1339","1242","-97","-7.24","19550336","24901095326"
"064240","홈캐스트","4535","4890","355","7.83","15637358","82776485065"
"039610","화성밸브","6210","5710","-500","-8.05","2931582","17929966690"
"002460","화성산업","9910","10370","460","4.64","879790","9033331044"
"378850","화승알앤에이","4985","4145","-840","-16.85","1897771","8522974105"
"241590","화승엔터프라이즈","8930","8530","-400","-4.48","5064018","43272141880"
"006060","화승인더","3780","3430","-350","-9.26","2093598","7351862790"
"013520","화승코퍼레이션","2190","1835","-355","-16.21","3180415","6113124362"
"010690","화신","21000","16190","-4810","-22.90","18119906","353017950560"
"126640","화신정공","1995","1671","-324","-16.24","5005394","9144796349"
"133820","화인베스틸","2450","2000","-450","-18.37","3100587","7220891301"
"127980","화인써키트","12250","11040","-1210","-9.88","1544264","20278712340"
"061250","화일약품","2010","2030","20","1.00","7334104","14814735553"
"010660","화천기계","4155","3620","-535","-12.88","18005930","72051419900"
"000850","화천기공","38450","36650","-1800","-4.68","92925","3378346100"
"016580","환인제약","14290","15090","800","5.60","2875089","40966382420"
"032560","황금에스티","8430","8020","-410","-4.86","3001139","24839955810"
"004800","효성","56900","62900","6000","10.54","1150764","68778795000"
"094280","효성ITX","12590","12240","-350","-2.78","298105","3684986700"
"097870","효성오앤비","8250","8140","-110","-1.33","2831886","24182262180"
"298040","효성중공업","121100","191300","70200","57.97","4207563","655982885200"
"298050","효성첨단소재","442000","461000","19000","4.30","953727","436784494000"
"298020","효성티앤씨","345000","339500","-5500","-1.59","678795","234694770500"
"298000","효성화학","81700","101900","20200","24.72","1226953","117482445500"
"093370","후성","12650","12900","250","1.98","44117375","592261931380"
"081660","휠라홀딩스","37450","40000","2550","6.81","3586633","139286805020"
"290270","휴네시온","4365","4160","-205","-4.70","833367","3598779370"
"005870","휴니드","5820","5650","-170","-2.92","3893908","23715409320"
"353190","휴럼","1274","1110","-164","-12.87","3639956","4225846338"
"192410","휴림네트웍스","596","498","-98","-16.44","13869076","7241281435"
"090710","휴림로봇","1800","1888","88","4.89","110582783","198180111968"
"205470","휴마시스","2330","3000","670","28.76","480444366","1346284959690"
"115160","휴맥스","3740","3450","-290","-7.75","6930650","25058337860"
"028080","휴맥스홀딩스","7520","6110","-1410","-18.75","3169820","21361969280"
"032860","휴먼엔","3640","3640","0","0.00","0","0"
"200670","휴메딕스","35600","41500","5900","16.57","2370837","87770097900"
"212310","휴벡셀","2310","3025","715","30.95","151622","391263940"
"079980","휴비스","4400","4400","0","0.00","1863531","7986809855"
"065510","휴비츠","22450","24000","1550","6.90","6601078","150199656850"
"215090","휴센텍","1505","1505","0","0.00","0","0"
"005010","휴스틸","6160","5920","-240","-3.90","27416808","177913475890"
"263920","휴엠앤씨","1199","1225","26","2.17","7754776","9103961660"
"243070","휴온스","30050","40800","10750","35.77","2983077","113608634400"
"084110","휴온스글로벌","19880","23300","3420","17.20","1172495","26058729630"
"145020","휴젤","105200","108000","2800","2.66","1413871","151615140600"
"024060","흥구석유","5360","5290","-70","-1.31","1071818","5534571175"
"010240","흥국","6550","6300","-250","-3.82","1784642","11912632100"
"189980","흥국에프엔비","2750","2505","-245","-8.91","3704221","9611308750"
"000540","흥국화재","3070","3080","10","0.33","842465","2526793280"
"000545","흥국화재우","5530","5000","-530","-9.58","47609","246447025"
"003280","흥아해운","2210","1918","-292","-13.21","113442097","289094266033"
"037440","희림","7800","7230","-570","-7.31","5380993","41865134760"
"238490","힘스","7250","6320","-930","-12.83","952941","6533215820"